_1-----------
_1-----------
_1-----------
_1-----------
_1-----------
_1-----------
_1-----------
_1-----------
_1-----------
_1-----------
_1-----------
_1-----------
_1-----------
_1-----------
_1-----------
_1-----------
_1--34-------
_1-----------
_1-----------
_1-----------
_56-78-------
_9:-3;<------
_1--78--34---
_1--34-------
_1--78-------
_1-----------
_1-----------
_1-----------
_=>?---------
_@AB---------
_1-----------
_1-----------
_1-----------
_1-----------
_1-----------
_1-----------
_1-----------
_1-----------
_=C>?--------
_@DAB--------
_EF----------
_GH----------
_1-----------
_1-----------
_1-----------
_1-----------
_=CC>?-------
_@DDAB-------
_1-----------
_1-----------
_1-----------
_1-----------
_I6----------
_J:----------
_KL----------
_M-----------
_1-----------
_=CC>?-------
_@DDAB-------
_1-----------
_1-----------
_1-----------
_1-----------
_1-----------
_1---NOP-----
_1-----------
_1-----------
_1-----------
_1-----------
-------------
-------------
_1-----------
_1-----------
_1-----------
_1-----------
_1-----------
_1-----------
_1--78-------
_1--3;<Q-----
_1--78RS-----
_1------78---
_1------7TU--
_1------7VW--
_1------78---
_1------78---
_1------78---
--------78---
--------78---
-------------
_1-----------
_1-----------
_1------78---
_1------78---
_1------78---
_XY-7Z[\34---
_]^----------
__`----------
_ab----------
_1-----------
_1-----------
_1--78-------
_1--Ncd------
_1-----------
_1-----------
_1-----------
_ef----------
_gh-34-------
_1-----------
_1-----------
_1--34--3;<--
_1-----------
_1-----------
_1--34-------
_1-----------
_1-----------
_1-----------
_1-----------
_1-----------
_1--78-------
_1-----------
_1-----------
_1------78---
_1------78---
_ij-----78---
_kl----------
_m^----------
_XY----------
_m^----------
_nF-----78---
_oH-78--34---
_1--78--34---
_1------78---
_1-----------
_1-----------
_pq----------
_prq---------
_prrq--------
_prrrq-------
_1-----------
_1-----------
_prrrq-------
_prrq--------
_prq---------
_pq----------
_1-----------
_1-----------
_1-----------
_1-----------
_pq----------
_prq---------
_prrq--------
_prrrq-------
_prrrq-------
-------------
-------------
_prrrq-------
_prrq--------
_prq---------
_pq----------
_1-----------
_1-----------
_1-----------
_1-----------
_=>?---------
_@AB---------
_1-----------
_1-----------
_1-----------
_1--78-------
_1--78-------
_1--34-------
_1--78-------
_1-----------
_st----------
_uv----------
_wx----------
_1-----------
_1-----------
_1-----------
_=>?---------
_@AB---------
_pq----------
_prq---------
_prrq--------
_prrrq-------
_prrrrq------
_prrrrrq-----
_prrrrrrq----
_prrrrrrrq---
_prrrrrrrq---
_1-----------
_1-----------
_1-----------
_1-----------
_1-----------
_1-----------
_1-----------
_1---------y-
_pz{{{{{{{|}-
