|:::::::::::
|:::::::::::
|:::::::::::
|:::::::::::
|:::::::::::
|:::::::::::
|:::::::::::
|:::::::::::
|:::::::::::
|:::::::::::
|:::::::::::
|:::::::::::
|:::::::::::
|:::::::::::
|:::::::::::
|:::::::::::
|:::?:::::::
|:::::::::::
|:::::::::::
|:::::::::::
|:::#:::::::
|g::?:::::::
|:::#:::?:::
|:::?:::::::
|:::#:::::::
|:::::::::::
|:::::::::::
|:::::::::::
|pp:::::::::
|pp:::::::::
|:::::::::::
|:::::::::::
|:::::::::::
|:::::::::::
|:::::::::::
|:::::::::::
|:::::::::::
|:::::::::::
|ppp::::::::
|ppp::::::::
|g::::::::::
|:::::::::::
|:::::::::::
|:::::::::::
|:::::::::::
|:::::::::::
|pppp:::::::
|pppp:::::::
|:::::::::::
|:::::::::::
|:::::::::::
|:::::::::::
|:::::::::::
|g::::::::::
|g::::::::::
|:::::::::::
|:::::::::::
|pppp:::::::
|pppp:::::::
|:::::::::::
|:::::::::::
|:::::::::::
|:::::::::::
|:::::::::::
|::::?m:::::
|:::::::::::
|:::::::::::
|:::::::::::
|:::::::::::
::::::::::::
::::::::::::
|:::::::::::
|:::::::::::
|:::::::::::
|:::::::::::
|:::::::::::
|:::::::::::
|:::#:::::::
|:::?:::::::
|:::#::g::::
|:::::::#:::
|:::::::#:::
|:::::::#g::
|:::::::#:::
|:::::::#:::
|:::::::#:::
::::::::#:::
::::::::#:::
::::::::::::
|:::::::::::
|:::::::::::
|:::::::#:::
|:::::::#:::
|:::::::#:::
|:::#:::?:::
|g::::::::::
|g::::::::::
|:::::::::::
|:::::::::::
|:::::::::::
|:::#:::::::
|:::#:::::::
|:::::::::::
|:::::::::::
|:::::::::::
|:::::::::::
|k::?:::::::
|:::::::::::
|:::::::::::
|:::?:::?:::
|:::::::::::
|:::::::::::
|:::?:::::::
|:::::::::::
|:::::::::::
|:::::::::::
|:::::::::::
|:::::::::::
|:::#:::::::
|:::::::::::
|:::::::::::
|:::::::#:::
|:::::::#:::
|g::::::#:::
|g::::::::::
|:::::::::::
|g::::::::::
|g::::::::::
|:::::::#:::
|:::#:::?:::
|:::#:::?:::
|:::::::#:::
|:::::::::::
|:::::::::::
|=::::::::::
|==:::::::::
|===::::::::
|====:::::::
|:::::::::::
|:::::::::::
|====:::::::
|===::::::::
|==:::::::::
|=::::::::::
|:::::::::::
|:::::::::::
|:::::::::::
|:::::::::::
|=::::::::::
|==:::::::::
|===::::::::
|====:::::::
|====:::::::
::::::::::::
::::::::::::
|====:::::::
|===::::::::
|==:::::::::
|=::::::::::
|:::::::::::
|:::::::::::
|:::::::::::
|:::::::::::
|pp:::::::::
|pp:::::::::
|:::::::::::
|:::::::::::
|:::::::::::
|:::#:::::::
|:::#:::::::
|:::?:::::::
|:::#:::::::
|:::::::::::
|a::::::::::
|g::::::::::
|g::::::::::
|:::::::::::
|:::::::::::
|:::::::::::
|:::::::::::
|g::::::::::
|g::::::::::
|==:::::::::
|===::::::::
|====:::::::
|=====::::::
|======:::::
|=======::::
|========:::
|========:::
|:::::::::::
|:::::::::::
|:::::::::::
|:::::::::::
|:::::::::::
|:::::::::::
|:::::::::::
|:::::::::f:
|fffffffffff
