654222322100
622254322371
654222354321
622254322381
654222322100
622222100000
622222100000
600000000000
600000000000
600000000000
600000000000
600000000000
600000000000
600000000000
600000000000
600090000000
6000;:000000
600090000000
600000000000
600000000000
6<0000000000
6<<000000000
6<<<=0000000
6<<<<0000000
6<<<<<000000
600000000000
600000000000
600000000000
A@?0;000;>00
6CB000009000
FED000009000
600000009000
600000000000
600000000000
6<<<<0000000
6<<000000000
600000000000
600000000000
HG0000000000
JI0000000000
LK0000000000
600000000000
600000000000
600000000000
600000000000
600000000000
6PPPONM00000
6TTTSRQ00000
600000000000
600000000000
600000000000
6000U0000000
600XWV000000
6000Y:00Y000
6000Y000Y000
6000Y000Y000
6000Y000Y000
6000Y000Y000
[Z0000000000
]\0000000000
^G0000000000
6_0000000000
600000000000
6a`000000000
dcb000000000
600000000000
^e0000000000
gf0000000000
ih0090000000
lk000000;j00
6m0000009000
600000009000
600000009000
600000000000
6PPPONM00000
6TTTSRQ00000
600000000000
600000000000
600000000000
6000Y0000000
6000Y0000000
6000Y0009000
6n00Y0009000
po000000;000
rq0000009000
ts00Y0009000
pu00Y0000000
6000Y0000000
600000000000
600000000000
600000000000
600000000000
000000009000
000000009000
000000009000
000000009000
600000000000
600000000000
600000000000
wv0000000000
6x0000000000
600000000000
600000000000
6PPPONM00000
6TTTSRQ00000
600000000000
000000000000
000000000000
000000000000
y00000000000
y00000000000
y00000000000
y00000000000
{z0000000000
600000000000
6PONM0000000
6TSRQ0000000
600000000000
g|0000000000
ih0000000000
600000000000
600000000000
6PPPONM00000
6TTTSRQ00000
600000000000
60000000;:00
6PPONM009000
6TTSRQ009000
600000009000
600000000000
6PPPPONM0000
6TTTTSRQ0000
600000000000
600000000000
600000000000
600000000000
600000000000
600000000000
600000000000
000000000000
000000000000
000000000000
600000000000
600000000000
600000000000
600000000000
600000000000
600000000000
600000000000
6~}00000000
6€000000000
600000000000
000000000000
000000000000
6<<<00000000
600000000000
600000000000
600000000000
600000000000
ƒ‚0000000000
…„0000000000
‰ˆ00;‡†00000
600000000000
600000000000
600‹Š0009000
600Œ0009000
600000009000
600000009000
600000009000
600000000000
60ŽY0000000
600000000000
60000000;:00
600000000000
600000000000
600000000000
6PPONM000000
6TTSRQ000000
F‘000000000
600000000000
600000000000
600000000000
600000000000
600000000000
600000000000
600090000000
60009000;000
600000000000
6“’000000000
600000000000
6<<<<<<<<<<0
6<<<<<<<<<<0
600000000000
600000000000
600000000000
600000000000
600000000000
600000000000
600000000000
6000000000”0
6<˜˜˜˜˜˜˜—–•
