0123444544677
0844923544:;6
0123444<23546
0844923544=>6
0123444544677
0844444677777
0844444677777
0?77777777777
0?77777777777
0?77777777777
0?77777777777
0?77777777777
0?77777777777
0?77777777777
0?77777777777
0?77@A7777777
0?77BCD777777
0?77@A7777777
0?77777777777
0?77777777777
0EF7777777777
0EGF777777777
0EGGHI7777777
0EGGGF7777777
0EGGGGF777777
0?77777777777
0?77777777777
0?77777777777
0JK7BL77BMN77
0OP77777@A777
0QR77777@A777
0?777777@A777
0?77777777777
0?77777777777
0EGGGF7777777
0EGF777777777
0?77777777777
0?77777777777
0ST7777777777
0UV7777777777
0WX7777777777
0?77777777777
0?77777777777
0?77777777777
0?77777777777
0?77777777777
0YZZ[\]777777
0^__`ab777777
0?77777777777
0?77777777777
0?77777777777
0?777c7777777
0?77de7777777
0?77fgD7fh777
0?77fh77fh777
0?77fh77fh777
0?77fh77fh777
0?77fh77fh777
0ij7777777777
0kl7777777777
0mT7777777777
0n77777777777
0?77777777777
0?o7777777777
0pq7777777777
0?77777777777
0rs7777777777
0tu7777777777
0vw7@A7777777
0xy77777Bz{77
0|}77777@A777
0?777777@A777
0?777777@A777
0?77777777777
0YZZ[\]777777
0^__`ab777777
0?77777777777
0?77777777777
0?77777777777
0?77fh7777777
0?77fh7777777
0?77fh77@A777
0~77fh77@A777
0Ä77777BL777
0ÅÇ77777@A777
0ÉÑ7fh77@A777
0ÖÜ7fh7777777
0?77fh7777777
0?77777777777
0?77777777777
0?77777777777
0?77777777777
77777777@A777
77777777@A777
77777777@A777
77777777@A777
0?77777777777
0?77777777777
0?77777777777
0áà7777777777
0âä7777777777
0?77777777777
0?77777777777
0YZZ[\]777777
0^__`ab777777
0?77777777777
7777777777777
7777777777777
7777777777777
0ã77777777777
0ã77777777777
0ã77777777777
0ã77777777777
0åç7777777777
0?77777777777
0Y[\]77777777
0^`ab77777777
0?77777777777
0éè7777777777
0vw7777777777
0?77777777777
0?77777777777
0YZZ[\]777777
0^__`ab777777
0?77777777777
0?777777BCD77
0YZ[\]77@A777
0^_`ab77@A777
0?777777@A777
0?77777777777
0YZZZ[\]77777
0^___`ab77777
0?77777777777
0?77777777777
0?77777777777
0?77777777777
0?77777777777
0?77777777777
0?77777777777
7777777777777
7777777777777
7777777777777
0?77777777777
0?77777777777
0?77777777777
0?77777777777
0?77777777777
0?77777777777
0?77777777777
0?êë777777777
0?íì777777777
0?77777777777
7777777777777
7777777777777
0EGGF77777777
0?77777777777
0?77777777777
0?77777777777
0?77777777777
0îï7777777777
0ñó7777777777
0òô7Böõú77777
0?7777777777ù
0?77777777777
0?77û777@A777
0?7ü†°77@A777
0?777777@A777
0?777777@A777
0?777777@A777
0?77777777777
0?7¢£h7777777
0?77777777777
0?777777BCD77
0?77777777777
0?77777777777
0?77777777777
0YZ[\]7777777
0^_`ab7777777
0§•7777777777
0?77777777777
0?77777777777
0?77777777777
0?77777777777
0?77777777777
0?77777777777
0?77@A7777777
0?77@A77BL777
0?77777777777
0¶ß®777777777
0?77777777777
0EGGGGGGGGGF7
0EGGGGGGGGGF7
0?77777777777
0?77777777777
0?77777777777
0?77777777777
0?77777777777
0?77777777777
0?77777777777
0?777777777©7
0E™´´´´´´´¨≠7
