0122344444444
0122563444444
0789:23444444
0122;<3444444
0122344444444
0=44444444444
0=44444444444
4444444444444
>?44444444444
@A44444444444
@BC4444444444
@BDC444444444
@BDDC44444444
@BDDC44444444
@BDDC44444444
EF44G44444444
44HIG44444444
44JKG44444444
4444G44444444
4444G44444444
4444G44444444
4444G44444444
4444G44444444
4444G44444444
4444G44444444
4444G44444444
4444G44444444
4444G44LM4444
4444G444N4444
4444G44444444
4444G44444444
DDDDC44444444
4444G44444444
4444G44444444
44OPG44444444
44QRG44444444
4444G444ST444
4444G444ST444
4444G444ST444
4444G444ST444
4444G44444444
4444G44444444
4444G44444444
4444G44444444
4444G44444444
4444G44444444
4444G44444444
DDDDCUV444444
4444GWX444444
4444G44444444
4444G44444444
4444G44444444
4444G44444444
4444G44444444
4444G44444444
4444G444ST444
Y444G44ST4444
Z444G444ST444
4444G44ST4444
4444G444ST444
4444G44444444
4444G444[\444
4444G444]^444
DDDD_44444444
4444444444444
4444444444444
4444444444444
4444444444444
DDDDC44444444
4444G`a444444
4444Gbc444444
4444G44444444
4444G444ST444
4444G4444ST44
4444G4444ST44
4444G444ST444
4444G44444444
4444G44444444
4444G44444444
DDDDC44444444
4444444444444
44444444de444
44444444fg444
4444444444444
DDDDC44444444
4444G44444444
4444G44444444
4444G44444444
hi44G44444444
jk44G44444444
4444G44444444
4444G44444444
4444G44444444
4444G44444444
4444G44444444
DDDDC44444444
4444444444444
444444lmST444
4444444nST444
DDDDDC44ST444
ooooop4444444
ooooop4444444
ooooop44qrs44
ooooop4444444
ooooop4444444
DDDDDC4444444
4tu4444444444
4vw4444444444
44444444ST444
44444444ST444
44444444ST444
4444444444444
>?44444444444
@A4xy44444444
@A4z{44444444
@A44444444444
@A44444444444
@A44444444444
@A44444444444
EF44444444444
4444444444444
4444444444444
4444G44444444
4444G44|}4444
4444G44~4444
4444444444444
4444444444444
DDDDC44444444
4444G44444444
4444G44444444
4444G44444444
4444G44444444
4444G44444444
4444G444ST444
4444G444ST444
44€G444ST444
44‚ƒG444ST444
4444G444ST444
4444G444ST444
4444G44„…4444
4444G44†‡4444
4444G44444444
4444G44444444
DDDDC44444444
4444444444444
4444444444444
DDC4444444444
44G4444444444
44G4444444444
44G44ST444444
44G44ST444444
44G44ST444444
44G44STˆ44444
44G4444‰Š4444
44G4444444444
DDC4444444444
4444444444444
4444444444444
4444444444444
DDDDC44444444
4444G44444444
4444G44444444
4444G44444444
44‹ŒG44444444
44ŽG44444444
4444G44444444
4444G44444444
4444G44444444
DDDDC44444444
4444444444444
4444444444444
4444G44444444
4444G44444444
4444444ST4444
4444444ST4444
4444G4T4444
4444G4‘’T4444
4444444ST4444
4444444444444
4444G44444444
4444G44444444
4444444444444
4444444444444
DDDDC44444444
4444G44444444
“”44G444•–444
—444G444˜™444
4444G44444444
4444G44444444
4444G44444444
4444G44444444
4444G44444444
>?44G44444444
@BDDC44444444
@BDDC44444444
@BDC444444444
@BC4444444444
@A44444444444
@A44444444444
@A44444444444
@A44444444444
@A44444444444
@A44444444444
@A44444444444
EF44444444444
4444444444444
4444444444444
0=44444444444
0šC4444444444
0šDC444444444
0šDDC44444444
0šDDDC4444444
0šDDDDC444444
0šDDDDDC44444
0šDDDDDDC4444
0šDDDDDDDC444
0šDDDDDDDC444
0=44444444444
0=44444444444
0=44444444444
0=44444444444
0=44444444444
0=44444444444
0=44444444444
0=444444444›4
0šœžŸ4
