322100000000
322541000000
376521000000
322581000000
322100000000
300000000000
300000000000
000000000000
900000000000
:00000000000
:;0000000000
:;;000000000
:;;;00000000
:;;;00000000
:;;;00000000
>00=<0000000
0@?=<0000000
0BA=<0000000
000=<0000000
000=<0000000
000=<0000000
000=<0000000
000=<0000000
000=<0000000
000=<0000000
000=<0000000
000=<0000000
000=<00DC000
000=<00E0000
000=<0000000
000=<0000000
;;;;00000000
000=<0000000
000=<0000000
0GF=<0000000
0IH=<0000000
000=<000J000
000=<000J000
000=<000J000
000=<000J000
000=<0000000
000=<0000000
000=<0000000
000=<0000000
000=<0000000
000=<0000000
000=<0000000
;;;;LK000000
000=NM000000
000=<0000000
000=<0000000
000=<0000000
000=<0000000
000=<0000000
000=<0000000
000=<000J000
000=<00J0000
O00=<000J000
000=<00J0000
000=<000J000
000=<0000000
000=<000QP00
000=<000SR00
;;;;<0000000
000000000000
000000000000
000000000000
000000000000
;;;;00000000
000=UT000000
000=WV000000
000=<0000000
000=<000J000
000=<0000J00
000=<0000J00
000=<000J000
000=<0000000
000=<0000000
000=<0000000
;;;;00000000
000000000000
00000000X000
00000000ZY00
000000000000
;;;;00000000
000=<0000000
000=<0000000
000=<0000000
[00=<0000000
]\0=<0000000
000=<0000000
000=<0000000
000=<0000000
000=<0000000
000=<0000000
;;;;00000000
000000000000
000000_^J000
000000a`J000
;;;;;000J000
ccccb<000000
ccccb<000000
ccccb<00ed00
ccccb<000000
ccccb<000000
;;;;;0000000
0gf000000000
0ih000000000
00000000J000
00000000J000
00000000J000
000000000000
900000000000
:0kj00000000
:0ml00000000
:00000000000
:00000000000
:00000000000
:00000000000
>00000000000
000000000000
000000000000
000=<0000000
000=<00n0000
000=<00po000
000000000000
000000000000
;;;;00000000
000=<0000000
000=<0000000
000=<0000000
000=<0000000
000=<0000000
000=<000J000
000=<000J000
00rq<000J000
00ts<000J000
000=<000J000
000=<000J000
000=<00vu000
000=<00xw000
000=<0000000
000=<0000000
;;;;00000000
000000000000
000000000000
;;0000000000
0=<000000000
0=<000000000
0=<00J000000
0=<00J000000
0=<00J000000
0=<00Jzy0000
0=<000|{0000
0=<000000000
;;0000000000
000000000000
000000000000
000000000000
;;;;00000000
000=<0000000
000=<0000000
000=<0000000
00}=<0000000
00~=<0000000
000=<0000000
000=<0000000
000=<0000000
;;;;00000000
000000000000
000000000000
000=<0000000
000=<0000000
0000000J0000
0000000J0000
000=<ÄJ0000
000=<ÇÅJ0000
0000000J0000
000000000000
000=<0000000
000=<0000000
000000000000
000000000000
;;;;00000000
000=<0000000
Ö00=<000ÑÉ00
à00=<000áÜ00
000=<0000000
000=<0000000
000=<0000000
000=<0000000
000=<0000000
900=<0000000
:;;;00000000
:;;;00000000
:;;000000000
:;0000000000
:00000000000
:00000000000
:00000000000
:00000000000
:00000000000
:00000000000
:00000000000
>00000000000
000000000000
000000000000
300000000000
3;0000000000
3;;000000000
3;;;00000000
3;;;;0000000
3;;;;;000000
3;;;;;;00000
3;;;;;;;0000
3;;;;;;;;000
3;;;;;;;;000
300000000000
300000000000
300000000000
300000000000
300000000000
300000000000
300000000000
3000000000â0
3;çççççççåãä
