0123444544677
0844923544:;6
0123444<23546
0844923544=>6
0123444544677
0844444677777
0844444677777
0?77777777777
0?77777777777
0?77777777777
0?77777777777
0?77777777777
0?77777777777
0?77777777777
0?77777777777
0?77777777777
0?77777777777
0?77777777777
0?77777777777
0?77777777777
0?77777777777
0@ABCD7777777
0EFGHI7777777
0?77777777777
0?77777777777
0?77JKL7JM777
0?77777777777
0NO7777777777
0PQ7777777777
0?77777777777
0?77777RS7777
0?77777777777
7777777777777
7777777777TU7
0?77777777777
0?77777777777
0?77777777777
0?77777777777
0?77777777777
0?77777777777
0?77777777777
0?77VW7777777
0?777VW777777
0?777VW777777
0?77VW7777777
0?77777777777
0?77777777777
0?77777777777
0?77777777777
0?77777777777
0?77777777777
0?77777777777
0?77777777777
0?77777777777
0?77777777777
0?77777777777
0?77777777777
0?77777777777
0?77777777777
0?77777777777
0?77777777777
0?77777777777
0?77777777777
0?77777777777
0?77JM77JM777
0?77777777777
0?77JM77JM777
0?77777777777
0?77777777777
0?77777777777
0?77777777777
0?77777777777
0?77777777777
0?77777777777
0?77777777777
0?77777777777
0?77777777777
0?77777777777
7777777777777
7777777777777
7777777777777
7777777777777
0?77777777777
0?77777777777
0?77777777777
0?77777777777
0?77777777777
0?77777777777
0?77777777777
0?77777777777
0?77JM7777777
0?77JM7777777
0?77JM77XYZ77
0?77JM7777777
0?77777777777
0?77777777777
0?77777777777
0?77777777777
0?77777777777
0?77777777777
0?77777777777
0?77777777777
0?77777777777
0[\\]77777777
0?77777777777
0?77777VW7777
0?77777VW7777
0?77777VW7777
0?77777VW7777
0?77777777777
0?77777777777
0?77777777777
0?77777777777
0?77777777777
0?77777777777
0?77777777777
0@AABCD777777
0EFFGHI777777
0?77777777777
0?77777VW7777
0?77777VW7777
0?77777VW7777
0?77777VW7777
0?77777777777
0?77777777777
0?77777777777
0?77777777777
0?77777777777
0?77777777777
0?77777777777
0?77777777777
0?77777777777
0@AABCD777777
0EFFGHI777777
0?77777777777
0?77777VW7777
0?77777VW7777
0?77777VW7777
0?77777VW7777
0?77777777777
0?77777777777
0?77777777777
0?77777777777
0?77777777777
0?77777777777
0?77777777777
0?77JM7777777
0?77JM7777777
0?77JKL7JM777
7777^_77JM777
7777^_77JM777
0?77JM77JM777
0?77JM7777777
0?77JM7777777
0?77777777777
0?77777777777
0?77777777777
0?77777777777
0?77777777777
0?77777777777
0?77777777777
0?77777777777
0?77777777777
0@BCD77777777
0EGHI77777777
0?77777777777
0?77777777777
0?77777777777
0?77777777777
0?77777777777
0?77777777777
0?77777777777
0?77777777777
0?77777777777
7777777777777
7777777777777
7777777777777
0?77777777777
0?77777777777
0?77777777777
7777777777777
7777777777777
0?77777777777
0?77777777777
0?77777777777
0?77777777777
0?77777777777
0?77777777777
0?77777777777
0[\\]77777777
7777777777777
7777777777777
0?77777777777
0?77777777777
0?77777777777
0?77777777777
0?77777777777
0?77777777777
0?77777777777
0?77777777777
0?77777777777
0?77777777777
0?77777777777
0?77777777777
0?77777777777
0?77777777777
0?77777777777
0?77777777777
0[]7777777777
0[\]777777777
0[\\]77777777
0[\\\]7777777
0[\\\\]777777
0[\\\\\]77777
0[\\\\\\]7777
0[\\\\\\\]777
0[\\\\\\\]777
0?77777777777
0?77777777777
0?77777777777
0?77X`ab77777
0?77777777777
0?77777777777
0?77777777777
0?777777777c7
0[deeeeeeefg7
