0122344444444
0122563444444
0789:23444444
0122;<3444444
0122344444444
0=44444444444
0=44444444444
0=44444444444
0=44444444444
0=44444444444
0=44444444444
0=44444444444
0=44444444444
0=44444444444
0>?4444444444
0@A4444444444
0=44444444444
0BC4444444444
0DE4444444444
0FG4444444444
0HI4444444444
0JK4444444444
0=44444444444
0=44444444444
0=44444444444
0=44444444444
0=44444444444
0=44444444444
0LM4444444444
0NO4444444444
0PQ4444444444
0RS4444444444
0TU4444444444
0=44444444444
0=44444444444
0=44444444444
0=44444444444
0VW4444444444
0XY4444444444
0Z44444444444
0Z44444444444
0Z44444444444
0Z44444444444
0Z44444444444
0[\]^_4444444
0`abcd4444444
0=44444444444
0=44444444444
0=44444444444
4444444444444
4444444444444
0e\]fg4444444
0`abhi4444444
0=44444444444
0=44444444444
0=44444444444
0=44444444444
0=4jkl4444444
0=44444444444
0=44444444444
0=44444444444
0=44444444444
0=44444444444
0mn4444444444
0oS4444444444
0pU4444444444
0qQ4444444444
0=44444444444
0=44444444444
0=44444444444
0=44444444444
0=44444444444
0rs4444444444
0tu4444444444
0vw4444444444
0mn4444444444
0x44444444444
0=44444444444
0=44444444444
0=44444444444
0=44444444444
0=44444444444
0=44444444444
0=4yz{4444444
0=4|}44444444
0=44444444444
0=44444444444
0=44444444444
0=44444444444
0~Ä4444444
0=44ÅÄ44ÇÉ444
0=44ÅÄ44ÑÖÜ44
4444ÅÄ44ÇÉ444
4444ÅÄ4444444
4444444444444
4444444444444
0=44444444444
0=44444444444
0=44444444444
0=44444444444
0=44444444444
0=44444444444
0áà4444444444
0âä4444444444
0ãK4444444444
0rs4444444444
0åç4444444444
0=44444444444
0=44444444444
0=44444444444
0=44444444444
0éèê444444444
0=44444444444
0=44444444444
4444444444444
4444444444444
0~Ä44444444
0=44444444444
0=44444444444
0áà4444444444
0âä4444444444
0ãK4444444444
0ëG4444444444
0íì4444444444
0=44444444444
0=î4444444444
0ïñ4444444444
0=44444444444
0=44444444444
0=44444444444
0=44444444444
0=44444444444
0óò4444444444
0ôö4444444444
0=44444444444
0=44444444444
0=44444444444
0=44444444444
0=44444444444
0=44444444444
0=44444444444
0=44444444444
0=44444444444
0=õ4444444444
0úù4444444444
0ûü4444444444
0†°4444444444
0~Ä4444444
0=44Ñ¢£444444
0=44ÇÉ4444444
0=44ÇÉ4444444
0=44444444444
4444444444444
4444444444444
4444444444444
0=44444444444
0=44Å§]^_4444
0=44Å•b¶d4444
0=4444ß®44444
0éèê444444444
0©44444444444
0™44444444444
0=44444444444
0´]^_44444444
0¨≠¶d44444444
0=44444444444
0=44444444444
0=44444444444
0=44444444444
0=44444444444
0éèê444444444
0=44444444444
0=44444444444
0=44444444444
0=44444444444
0=4ÆØ44444444
0=4∞±44444444
0=44444444444
0=44444444444
0=44444444444
0=4≤≥¥4444444
0=4µ∂44444444
0~Ä4444444444
0~Ä444444444
0~Ä44444444
0~Ä4444444
0~Ä444444
0=44444444444
0=44444444444
0=4ÅÄ444
0=4ÅÄ444
0=44444444444
0=44444444444
0=44444444444
0=44444444444
0=44444444444
0=44444444444
0=44444444444
0=444444444∑4
0~∏πππππππ∫ª4
