0122344444444
0122563444444
0789:23444444
0122;<3444444
0122344444444
0=44444444444
0=44444444444
0=44444444444
0=44444444444
0=44444444444
0=44444444444
0=44444444444
0>?4444444444
0>@?444444444
0>@@?44444444
0>@@@?4444444
0=44A?4444444
0=44ABCD44444
0=44A?4444444
0=44444444444
0EF4444444444
0GH444444IJ44
0=4444444IJ44
0=4444444IJ44
0=44444444444
0KLM444444444
4444444444444
4444444444444
4444444444444
0=44NOJ4NP444
0=44NOJ4NP444
0=44NOJ4NP444
0=44NP44NP444
0=44NP44NP444
0=44NP44QRS44
0=44444444444
0=44444444444
0=44444444444
0=4TU44444444
0=4VW44444444
0=44444444444
0=44444444444
0=44444444444
0=44444444444
0>?4444444444
0>@XY44444444
0>@@?44444444
0>@@@?4444444
0>@@@?4444444
0>@?444444444
0=44444444444
0=44444444444
0=44444444444
0=44444444444
0=44444444444
0Z[\]^4444444
0_`abc4444444
0=44444444444
0=44444444444
0=44444444444
0de4444444444
0fg4444444444
0>?4444444444
0>@hi44444444
0>@@?44444444
0>@@@?4444444
4444444444444
4444444444444
0>@@@@?444444
0>@@@@@?44444
0>@@@@@?44444
0=44444444444
0=44444444444
0=44444444444
0=44444444444
0=44444444444
0=44444444444
0=44444444444
0=44jk4444444
0=44jk4444444
0=44jk4444444
0=4lmk4no4444
0=4pjk4444444
0=44444444444
0=44Qq4444444
0=444444Qq444
0=444444NOJ44
0=444444NOJ44
0=44444444444
0rJ44NP444444
0rJ44NP444444
0=444NP444444
4444444444444
4444444444444
4444444444444
4444444444444
0=44444444444
0=44444444444
0=44444444444
0=44444444444
0=44444444444
0=44444444444
0=44444444444
0=44444444444
0=44444444444
0=44st4444444
0=44u44444444
0vwD444444444
0=44444444444
0x44444444444
0y44444444444
0z44444444444
0z44444444444
0{44444444444
0=44444444444
0Z\]^44444444
0_abc44444444
0=44444444444
0=44NP44NP444
0=44NP44NP444
0=44NP44N|}44
0=44NP44N~44
0=44NP€4NP444
0=44N‚4NP444
0=44NP44NP444
0=44NP44Qƒ„44
0=44444444444
4444444444444
4444444444444
0>@@?44444444
0=44444444444
0=44444444444
0=44444444444
0=44444444444
0…44444444444
0†44444444444
0‡44444444444
0=44444444444
0=44444444444
0=44444444444
0=44444444444
0=Qˆ‰Š4444444
0=QRS44444444
0=44444444444
4444444444444
4444444444444
4444444444444
4444NP4444444
4444NP4444444
4444NP4444444
4444444444444
0=44444444444
0=44444444444
0=444444NP444
0‹i44444NP444
0Œ44444NP444
0Ž444444N44
0=444444N‘’44
0=44444444444
0=44444444444
0=44444444444
0=44444444444
0=44444444444
0=44444444444
0=4“”•4444444
0=4–—˜4444444
0=4™š44444444
0=44444444444
0=44QRS444444
0=44444444444
4444444444444
4444444444444
44444444NOJ44
0Z\]^444NOJ44
0_abc444NP444
44444444NP444
4444444444444
0=44444444444
0=44444444444
0=44444444444
0=44444444444
0=44444444444
0=44444444444
0>?4444444444
0>@?444444444
444444›444444
0>@@@œ444444
0>@@@@?444444
4444444444444
0>@@@@@@?4444
0>@@@@@@@?444
0>@@@@@@@?444
0=44444444444
0=44444444444
0=44444444444
0=44444444444
0=44444444444
0=44444444444
0=44444444444
0=444444444ž4
0Ÿ ¡¡¡¡¡¡¡¢£4
