0122344444444
0122563444444
0789:23444444
0122;<3444444
0122344444444
0=44444444444
0=44444444444
0=44444444444
0=44444444444
0=44444444444
0=44444444444
0=44444444444
0=44444444444
0=44444444444
0=44444444444
0=44444444444
4444444444444
4444444444444
4>?4444444444
@AB4444444444
@AB4444444444
4CD4444444444
4444444444444
4444444444444
4444>?4444444
@@@@AB444EF44
@@@@AB44>GH44
@@@@AI@@AJK44
@@@@AI@@AJK44
@@@@AI@@AJK44
@@@@AB44CD444
4444CD4444444
4>?4444444444
@AJK444444444
4CD4444444444
44444>?444444
@@@@@AB444444
@@@@@AB4444LK
@@@@@AB4444LK
44444CD444444
444444444>?44
@@@@@@@@@AMN4
@@@@@@@@@AB44
@@@@@@@@@AB44
@@@@@@@@@AMN4
@@@@@@@@@AB44
444444444CD44
4444444444444
4444444444444
4444444444444
>?44444LK4444
AB44444LK4444
AB44444444444
CD44444444444
4444444444444
444O444444444
444O444444444
4444444444444
4444444444444
>?4PQR4444444
AB444444>SK44
AI@@@@@@AJK44
AI@@@@@@AJK44
CD444444CTK44
4444444444444
>?44444444444
AB44444444444
AB44444444444
AB44444444444
CD44444444444
4444>?4444444
@@@@AB4444444
4444CD4444444
4444444444444
44444444UVW44
4444444444444
4444444>?4444
@@@@@@@AXY444
@@@@@@@AB4444
@@@@@@@AB4444
@@@@@@@AB4444
4444444CD4444
4444444444444
4444444444444
4444444444444
44444444LK444
44444Z[4LK444
44444Z[444444
4444444444444
4444444444444
4444444444444
4444444444444
4444444444444
444444444LK44
4444Z[444LK44
4444Z[4444444
4444444444444
444444444LK44
44>?44444LK44
@@AB444444444
@@AB444444444
44CD444444444
4444444444444
4444444444444
444444>?44444
@@@@@@A\]4444
@@@@@@A^_4444
@@@@@@AB44444
@@@@@@AB44444
@@@@@@AB44444
@@@@@@AB44444
444444CD44444
4444444444444
>SK4444444444
AJK44444`a444
CTK4444444444
4444>?4444444
@@@@AB4444444
@@@@AB4444444
4444CD4444444
44444444LK444
44444444LK444
4444>?4444444
@@@@AB4444444
@@@@AB4444444
4444CD4444444
4444444444444
4444444bc4444
4444444Zd4444
0=44444ef4444
0=44444444444
0=44444444444
0=44444444444
0gh4444444444
0ij4444444444
0=44444444444
0=44444444444
0=44444444444
0klllm4444444
0klllm4444444
0klllllm44444
0klllllm44444
0klllllllm444
0klllllllm444
0=44444444444
0=44444444444
0=44444444444
0=44444444444
0=44444444444
0=44444444444
0=44444444444
0=444444444n4
0kopppppppqr4
