|:::::::::::
|:::::::::::
|:::::::::::
|:::::::::::
|:::::::::::
|:::::::::::
|:::::::::::
|:::::::::::
|:::::::::::
|:::::::::::
|:::::::::::
|:::::::::::
|:::::::::::
|:::::::::::
|:::::::::::
|:::::::::::
|:::::::::::
|:::::::::::
|:::::::::::
|zz:::::::::
|:::::::::::
|:::::::::::
|:::::::::::
|:::::::::::
|:::K:::::::
|:::::::::::
|:::::::::::
|:::::::#:::
|ZZZ::::#:::
|:::::::#:::
|:::::::::::
|:::::::::::
|:::::::::::
|:::::::::::
|:::::::::::
|:::::::::::
|zz:::::::::
|:::::::::::
|:k:::::::::
|:::?:::::::
|:::?:::::::
|:::?:::::::
|:::?:::::::
|:::::::::::
|:::::::::::
|:::::::::::
|ZZZ::::::::
|:::::::::::
|:::::::::::
|:::::::::::
|:::::::::::
|::k::::::::
|:::::::::::
|:::::::::::
|:::::::::::
|:::::::::::
|ZZZ::::::::
|:::::::::::
|:::::::::::
|:::::::::::
|:::::::::::
|:::::::::::
|:::#:::::::
|:::#:::::::
|:::=zz:::::
|:::#:::::::
|:::#:::::::
|:::::::::::
|zz:::::::::
|:::::::::::
|:::::::::::
|:::::::::::
|:::::::::::
::::::::::::
::::::::::::
|:::::::::::
|ppppe::::::
|ppppe::::::
|:::::::::::
|:::::::::::
|:::::::::::
|:::::::::::
|:::#:::#:::
|:::#:::#:::
|:::#h::#:::
|:::#:::#:::
|:::#:::#h::
|:::#:::#:::
|:::#:::#:::
|:::::::::::
|:::::::::::
|:::::::::::
|:::::::::::
|ppppe::#m::
|ppppe::::::
|:::::::::::
|:::::::::::
|:::::::::::
|:::::::::::
|:::::::::::
|:::::::::::
|:::::::::::
|:::::::::::
|:::::::::::
|zz:::::::::
|:::::::::::
|:::::::::::
|:::::::::::
|:::::::::::
|ppppe::::::
|ppppe::::::
|k::::::::::
|:::::::::::
|:::::::::::
|:::::::::::
|pppe:::::::
|pppe:::::::
|:::::::::::
|:::::::::::
|:::::::::::
|:::::::::::
|:::::::::::
|zz:::::::::
|:::::::::::
|:::::::::::
|:::::::::::
|:::::::::::
|:::::::::::
|pppe:::::::
|pppe:::::::
|:::::::::::
|:::::::::::
|:::::::::::
|:::::::::::
|:::#:::#:::
|:::#h::#:::
|:::#:::#:::
|h::#:::#:::
|:::#:::#:::
|:::::::::::
|:::::::::::
|===::::::::
|:::::::::::
|:::::::::::
|:::::::::::
|:::::::::::
|ZZZ::::::::
|:::::::::::
|:::::::::::
|::::#::::::
|::::#::::::
|SS:::::::#m
::::::::::::
|=:::::#::::
|==::::#::::
|===::::::::
|====:::::::
|=====::::::
|======:::::
|:::::::::::
|:::::::::::
|:::::::::::
|=::::::::::
|==:::::::::
|===::::::::
|====:::::::
|=====::::::
|======:::::
|=======::::
|========:::
|========:::
|:::::::::::
|:::::::::::
|:::::::::::
|:::::::::::
|:::::::::::
|:::::::::::
|:::::::::::
|:::::::::f:
|fffffffffff
