654222322100
622254322371
654222354321
622254322381
654222322100
622222100000
622222100000
600000000000
600000000000
600000000000
600000000000
600000000000
600000000000
600000000000
600000000000
600000000000
600000000000
600000000000
600000000000
6:9000000000
600000000000
600000000000
600000000000
600<;0000000
600>=0000000
600000000000
600000000000
60000000@?00
69:90000A000
60000000A000
600000000000
600000000000
600000000000
600000000000
600000000000
600000000000
6:9000000000
600000000000
6DCB00000000
6GF0E0000000
6000E0000000
6000E0000000
6000E0000000
600000000000
600000000000
600000000000
6H:900000000
600000000000
600000000000
600000000000
600000000000
60JI00000000
60LK00000000
600000000000
600000000000
600000000000
6M:900000000
600000000000
600000000000
600000000000
600000000000
600000000000
6000A0000000
6000A0000000
6000N:900000
6000@PO00000
6000A0000000
600000000000
6:9000000000
600000000000
600000000000
600000000000
600000000000
000000000000
000000000000
600000000000
6TTSRQ000000
6XXWVU000000
600000000000
6000000Y0000
600000[Z0000
60000000\000
6000A000]000
6000A_^0A000
6000Aa`0A000
6000A000A00b
6000A000Aedc
6000A000Af00
6000A000A000
600000000000
600000000000
600000000000
600000000000
6TTSRQ00@g00
6XXWVU000000
600000000000
600000000000
600000000000
600000000000
600000000000
600000000000
600000000000
600000000000
600000000000
6:9000000000
600000000000
600000000000
600000000000
600000000000
6TTSRQ000000
6XXWVU000000
6ih000000000
j00000000000
600000000000
600000000000
6TSRQ0000000
6XWVU0000000
600000000000
600000000000
600000000000
600000000000
600000000000
6:9000000000
600000000000
600000000000
600000000000
600000000000
600000000000
6TSRQ0000000
6XWVU0000000
600000000000
600000000000
600000000000
600000000000
6000Anmlk000
6000Apo0A000
6rq0A000A000
6s00A000A000
6000A000A000
600000000000
600000000000
6NNN00000000
600000000000
600000000000
600000000000
600000000000
6M:900000000
600000000000
600000000000
60000A000000
60000A000000
6ut00000000@
000000000000
6N00000A0000
6NN0000A0000
6NNN00000000
6NNNN0000000
6NNNNN000000
6NNNNNN00000
600000000000
600000000000
600000000000
6N0000000000
6NN000000000
6NNN00000000
6NNNN0000000
6NNNNN000000
6NNNNNv00000
6NNNNNNN0000
6NNNNNNNN000
6NNNNNNNN000
600000000000
600000000000
600000000000
600000000000
600000000000
600000000000
600000000000
6000000000w0
6{zzzzzzzzyx
