0123444544677
0844923544:;6
0123444<23546
0844923544=>6
0123444544677
0844444677777
0844444677777
0?77777777777
0?77777777777
0?77777777777
0?77777777777
0?77777777777
0?77777777777
0?77777777777
0?77777777777
0?77777777777
0?77777777777
0?77777777777
0?77777777777
0@AB777777777
0?77777777777
0?77777777777
0?77777777777
0?7CDE7777777
0?7FGH7777777
0?77777777777
0?77777777777
0?777777IJK77
0LMAB777NO777
0?777777NO777
0?77777777777
0?77777777777
0?77777777777
0?77777777777
0?77777777777
0?77777777777
0@AB777777777
0?77777777777
0?PQ777777777
0?RSTU7777777
0?77TU7777777
0?77TU7777777
0?77TU7777777
0?77777777777
0?77777777777
0?77777777777
0VWXB77777777
0?77777777777
0?77777777777
0?77777777777
0?77777777777
0?7YZ77777777
0?7[\77777777
0?77777777777
0?77777777777
0?77777777777
0]^XB77777777
0?77777777777
0?77777777777
0?77777777777
0?77777777777
0?77777777777
0?77NO7777777
0?77NO7777777
0?77_`XB77777
0?77Iabc77777
0?77NO7777777
0?77777777777
0@AB777777777
0?77777777777
0?77777777777
0?77777777777
0?77777777777
7777777777777
7777777777777
0?77777777777
0defgh7777777
0ijklm7777777
0?77777777777
0?77777n77777
0?77777o77777
0?7777777p777
0?77NO77qr777
0?77NOs7NO777
0?77Ntu7NO777
0?77NO77NO77v
0?77NO77Nwx7y
0?77NO77Nz{77
0?77NO77NO777
0?77777777777
0?77777777777
0?77777777777
0?77777777777
0defgh77I|}77
0ijklm7777777
0?77777777777
0?77777777777
0?77777777777
0?77777777777
0?77777777777
0?77777777777
0?77777777777
0?77777777777
0?77777777777
0@XB777777777
0?77777777777
0?77777777777
0?77777777777
0?77777777777
0defgh7777777
0ijklm7777777
0~7777777777
0Ä77777777777
0?77777777777
0?77777777777
0dfgh77777777
0iklm77777777
0?77777777777
0?77777777777
0?77777777777
0?77777777777
0?77777777777
0@XB777777777
0?77777777777
0?77777777777
0?77777777777
0?77777777777
0?77777777777
0dfgh77777777
0iklm77777777
0?77777777777
0?77777777777
0?77777777777
0?77777777777
0?77NOÅ7ÇO777
0?77NtÉ7NO777
0ÑÖ7NO77NO777
0Üá7NO77NO777
0?77NO77NO777
0?77777777777
0?77777777777
0àââä77777777
0?77777777777
0?77777777777
0?77777777777
0?77777777777
0]^XB77777777
0?77777777777
0?77777777777
0?777NO777777
0?777NO777777
0ãåç7777777IJ
7777777777777
0àä7777NO7777
0àâä777NO7777
0àââä77777777
0àâââä7777777
0àââââä777777
0àâââââä77777
0?77777777777
0?77777777777
0?77777777777
0àä7777777777
0àâä777777777
0àââä77777777
0àâââä7777777
0àââââä777777
0àâââââé77777
0àââââââä7777
0àâââââââä777
0àâââââââä777
0?77777777777
0?77777777777
0?77777777777
0?77777777777
0?77777777777
0?77777777777
0è77777777777
0ê777777777ë7
0íìîîîîîîîïñ7
