0123444544677
0844923544:;6
0123444<23546
0844923544=>6
0123444544677
0844444677777
0844444677777
0?77777777777
0?77777777777
0?77777777777
0?77777777777
0?77777777777
0?77777777777
0?77777777777
0@77777777777
0?77777777777
0?77777777777
0?77777777777
0?77777777777
0?77777777777
0AB7777777777
0CD7777777777
0EF7777777777
0GH7777777777
0CD7777777777
0?77777777777
0?77777777777
0?77777777777
0?77777777777
0?77777777777
0?77777777777
0IJ7777777777
0KL7777777777
0?77777777777
0?77777777777
0MNNOPQ777777
0RSSTUV777777
0?77777777777
0?77777777777
0?77777777777
0?77777777777
0WX7777777777
0YZ7777777777
0[\7777777777
0?77777777777
0?77777777777
7777777777777
0?77777777777
7777777777777
0?77777777777
0?77777777777
7777777777777
0?77777777777
0?77777777777
7777777777777
0?77777777777
0?77777777777
7777777777777
0]^7777777777
0_`7777777777
0?77777777777
0?77777777777
0?77777777777
0?77777777777
0?777ab777777
0?77777777777
0?77777777777
0?77777777777
0cd7777777777
0ef7777777777
0gh7777777777
0cd7777777777
0ij7777777777
0?77777777777
0?77777777777
0?77777777777
0MNNOPQ777777
0RSSTUV777777
0?77777777777
0?77777777777
0?777klm77777
0?77777777777
0MNOPQ7777777
0RSTUV7777777
0?77777777777
0?77777777777
0?77777777777
0?77777777777
0?77777777777
0?77777777777
0?77777777777
0?77777777777
0?77777777777
0?77777777777
0MNNOPQ777777
0RSSTUV777777
0?77777777777
0?77777777777
0?777ab777777
0?77777777777
0?77777777777
0?77777777777
0?77777777777
0?77777777777
0MNNOPQ777777
0RSnoUV777777
0pq7777777777
0gh7777777777
0cd7777777777
0rs777777ab77
0tD777777ab77
0?77777777777
0?77777777777
0?77777777777
0?77777777777
0MOPQ77777777
0uTUV77777777
0vw7777777777
0?77777777777
0?77777777777
0?77777777777
0?77777777777
0?77777777777
0xy7777777777
0z{7777777777
0?77777777777
0?77777777777
0?77777777777
0|}7777777777
0~7777777777
0ÄÅ7777777777
0ÇÉ7777777777
0ÑÖ7777777777
0?77777777777
0?77777777777
0?77777777777
0?77777777777
0?77777777777
0?77777777777
0?77777777777
0MNOPQ7777777
0RSTUV7777777
0?77777777777
0?77777777777
0?77777777777
0?77777777777
0Ü77777777777
0áà7777777777
0âä7777777777
0ãå7777777777
0áà7777777777
0?77777777777
0?77777777777
0çéééè7777777
0?777777êë777
0?777777êë777
0?777777êë777
0?777777êë777
0?77kí77kìî77
0?7ïñ777êë777
0?7óò777êë777
0?777777êë777
0?77777777777
0çéééè7777777
0?77777777777
0?77777777777
0?77777777777
0?77777777777
0?77777777777
7777777777777
0?7ôöõ7777777
7777777777777
0?77777777777
0?77777777777
77úù777777777
0?ûü777777777
7777777777777
0?77777777777
0?77777777777
7777777777777
0?77777777777
0†77777777777
0°77777777777
0°77777777777
0°777êë777777
0°777êë777777
0°777k¢£77777
0°777êë777777
0°777êë777777
0§777êë777777
0?777êë777777
0?777êë777777
0?77777777777
0?77777777777
0?77777777777
0?77777777777
0?77777777777
7777777777777
0?77777777777
7777777777777
0?77777777777
7777777777777
0?77777777777
0?77777777777
0?77777777777
0•¶7777777777
0ß®7777777777
0©™7777777777
0?77777777777
0?77777777777
0çéè777777777
0?77777777777
0?77777777777
0?77777777777
0?77777777777
0?77777777777
0?77777777777
0?77777777777
0?77777777777
0?77777777777
0?77777777777
7777777777777
7777777777777
77777ab777777
77777ab777777
7777777777777
7777777777777
0?77777777777
0?77777777777
0?77777777777
0?77777777777
0´ä7777777777
0¨≠7777777777
0ÆØ7777777777
0´ä7777777777
0∞å7777777777
0?77777777777
7777777777777
0MNOPQ7777777
0RSTUV7777777
7777777777777
7777777777777
0MNNOPQ777777
0RSSTUV777777
7777777777777
7777777777777
0MNNNOPQ77777
0RSSSTUV77777
0?77777777777
0?77777777777
0?77777777777
0?77777777777
0?77777777777
0?77777777777
0?77777777777
0cd7777777777
0ef7777777777
0gh7777777777
0±d7777777777
0≤j7777777777
0?77777777777
0≥¥7777777777
0µ∂7777777777
0?77777777777
0?77777777777
0?77777777777
0?77777777777
0?77777777777
0?77777777777
0?77777777777
0?77777777777
0∑∏7777777777
0π∫7777777777
0?77777777777
0?77777777777
0çè7777777777
0çéè777777777
0çééè77777777
0çéééè7777777
0çééééè777777
0çéééééè77777
0°77777777777
0°77777777777
0°777ab777777
0°777ab777777
0ª77777777777
0?77777777777
0?77777777777
0?77777777777
0?77777777777
7777777777777
77777ab777777
7777777777777
0?77777777777
0?77777777777
7777777777777
77777ab777777
7777777777777
0?77777777777
0?77777777777
0?77777777777
0?77777777777
0?77777777777
0çéè777777777
0º77777777777
0Ωæ7777777777
0?77777777777
0çéè777777777
0?77777777777
0ø77777777777
0?77777777777
0ø77777777777
0ø77777777777
0?77777777777
7777777777777
7777777777777
77777ab777777
77777ab777777
7777777777777
0?77777777777
7777777777777
77777ab777777
77777ab777777
7777777777777
0?77777777777
0?77777777777
0?77777777777
0?77777777777
0?77777777777
0?77777777777
0?¿7777777777
0¡¬7777777777
0?77777777777
0?77777777777
0?77777777777
0?77777777777
0?77777777777
0?77777777777
0WX7777777777
0√ƒ7777777777
0≈∆7777777777
0«æ7777777777
0?77777777777
0?77777777777
0MNOPQ7777777
0RSTUV7777777
0?77777777777
0?77777777777
0?77777777777
0?77777777777
0?77777777777
0?77777777777
0?77777777777
0?77777777777
0?77777777777
0MOPQ77777777
0RTUV77777777
0?77777777777
0?77777777777
7777777777777
0çéè777777777
7777777777777
0çéééè7777777
7777777777777
0çéééééè77777
7777777777777
0çéééééééè777
0çéééééééè777
0?77777777777
0?77777777777
0?77777777777
0?77777777777
0?77777777777
0?77777777777
0?77777777777
0?777777777»7
0ç…       ÀÃ7
