654222322100
622254322371
654222354321
622254322381
654222322100
622222100000
622222100000
600000000000
600000000000
600000000000
600000000000
600000000000
600000000000
600000000000
900000000000
600000000000
600000000000
600000000000
600000000000
600000000000
;:0000000000
=<0000000000
?>0000000000
;@0000000000
=<0000000000
600000000000
600000000000
600000000000
600000000000
600000000000
600000000000
BA0000000000
DC0000000000
600000000000
600000000000
6HHHGFE00000
6LLLKJI00000
600000000000
600000000000
600000000000
600000000000
6NM000000000
QPO000000000
6R0000000000
600000000000
600000000000
000000000000
600000000000
000000000000
600000000000
600000000000
000000000000
600000000000
600000000000
000000000000
600000000000
600000000000
000000000000
6TS000000000
VU0000000000
600000000000
600000000000
600000000000
600000000000
60000W000000
600000000000
600000000000
600000000000
YX0000000000
[Z0000000000
]\0000000000
YX0000000000
[^0000000000
600000000000
600000000000
600000000000
6HHHGFE00000
6LLLKJI00000
600000000000
600000000000
60000`_00000
600000000000
6HHGFE000000
6LLKJI000000
600000000000
600000000000
600000000000
600000000000
600000000000
600000000000
600000000000
600000000000
600000000000
600000000000
6HHHGFE00000
6LLLKJI00000
600000000000
600000000000
60000W000000
600000000000
600000000000
600000000000
600000000000
600000000000
6HHHGFE00000
6LbaKJI00000
6c0000000000
]\0000000000
YX0000000000
ed0000000W00
f<0000000W00
600000000000
600000000000
600000000000
600000000000
6HGFE0000000
6gKJI0000000
Qih000000000
600000000000
600000000000
600000000000
600000000000
600000000000
6kj000000000
6l0000000000
600000000000
600000000000
600000000000
onm000000000
Vqp000000000
tsr000000000
6vu000000000
Vw0000000000
600000000000
600000000000
600000000000
600000000000
600000000000
600000000000
600000000000
6HHGFE000000
6LLKJI000000
600000000000
600000000000
600000000000
600000000000
6x0000000000
zy0000000000
|{0000000000
~}0000000000
zy0000000000
600000000000
600000000000
60000000
60000000€000
60000000€000
60000000€000
60000000€000
6000`000`‚0
60„ƒ0000€000
60†…0000€000
60000000€000
600000000000
60000000
600000000000
600000000000
600000000000
600000000000
600000000000
000000000000
600ˆ‡0000000
000000000000
600000000000
600000000000
0Š‰000000000
6Œ‹00000000
000000000000
600000000000
600000000000
000000000000
600000000000
Ž00000000000
00000000000
00000000000
0000€000000
0000€000000
0000`00000
0000€000000
0000€000000
‘0000€000000
60000€000000
60000€000000
600000000000
600000000000
600000000000
600000000000
600000000000
000000000000
600000000000
000000000000
600000000000
000000000000
600000000000
600000000000
600000000000
6“’000000000
V•”000000000
o—–000000000
600000000000
600000000000
6000000000
600000000000
600000000000
600000000000
600000000000
600000000000
600000000000
600000000000
600000000000
600000000000
600000000000
000000000000
000000000000
00000W000000
00000W000000
000000000000
000000000000
600000000000
600000000000
600000000000
600000000000
˜{0000000000
š™0000000000
œ›0000000000
˜{0000000000
š0000000000
600000000000
000000000000
6HHGFE000000
6LLKJI000000
000000000000
000000000000
6HHHGFE00000
6LLLKJI00000
000000000000
000000000000
6HHHHGFE0000
6LLLLKJI0000
600000000000
600000000000
600000000000
600000000000
600000000000
600000000000
600000000000
YX0000000000
[Z0000000000
]\0000000000
Ÿž0000000000
6 0000000000
600000000000
¢¡0000000000
¤£0000000000
600000000000
600000000000
600000000000
600000000000
600000000000
600000000000
600000000000
600000000000
?¥0000000000
6¦0000000000
600000000000
600000000000
60000000000
6000000000
600000000
60000000
6000000
600000
00000000000
00000000000
0000W000000
0000W000000
§00000000000
600000000000
600000000000
600000000000
600000000000
000000000000
00000W000000
000000000000
600000000000
600000000000
000000000000
00000W000000
000000000000
600000000000
600000000000
600000000000
600000000000
600000000000
6000000000
Q00000000000
6©¨000000000
600000000000
6000000000
600000000000
600000000000
600000000000
600000000000
600000000000
600000000000
000000000000
000000000000
00000W000000
00000W000000
000000000000
600000000000
000000000000
00000W000000
00000W000000
000000000000
600000000000
600000000000
600000000000
600000000000
600000000000
600000000000
6«ª000000000
6­¬000000000
600000000000
600000000000
600000000000
600000000000
600000000000
600000000000
6NM000000000
Q¯®000000000
6°0000000000
V©¨000000000
600000000000
600000000000
6HHGFE000000
6LLKJI000000
600000000000
600000000000
600000000000
600000000000
600000000000
600000000000
600000000000
600000000000
600000000000
6HGFE0000000
6LKJI0000000
600000000000
600000000000
000000000000
6000000000
000000000000
60000000
000000000000
600000
000000000000
6000
6000
600000000000
600000000000
600000000000
600000000000
600000000000
600000000000
600000000000
6000000000±0
6µµµµµµµ´³²
