|:::::::::::
|:::::::::::
|:::::::::::
|:::::::::::
|:::::::::::
|:::::::::::
|:::::::::::
|:::::::::::
|:::::::::::
|:::::::::::
|:::::::::::
|:::::::::::
|:::::::::::
|:::::::::::
|:::::::::::
:::K::::::::
|:::::::::::
|=::::::::::
|==:::::::::
|===::::::::
|====:::::::
::::::R:::L:
|======:::K:
|=======::::
|========:::
|========:::
|:::::::::::
|:::::::::::
|:::::::::::
|:::?:::::::
|:::?:::::::
|:::?:::::::
|:::?:::::::
|:::::::::::
|:::::::::::
|:::::::::::
::::::::::::
|:::::::::::
|:::::::::::
|:::::::::::
|:::::::::::
|:::::::::::
|:::::::::::
|:::::::#:::
|SS:::::#m::
::::::::#:::
|:::::::#:::
|:::::::#:::
|:::::::#:::
|:::::::#:::
::::::::#:::
|:::::::#:::
::::::::#:::
|:::::::#:::
|:::::::#:::
|:::K:::#:::
::::::::#:::
|:::::::#:::
|:::::::#:::
|:::::::#:::
|:::::::#:::
|:::::::#:::
|:::::::#:::
::::::::#:::
|:::K:::#:::
|:::::::#:::
|:::::::#:::
|::K::::#:::
|:::::::#:::
|:::::::#:::
|:::::::#:::
|:::::::#:::
|:::::::#:::
|:::::::#:::
|:::::::#:::
|:::::::#:::
|:::::::::::
|:::#:::::::
::::#:::::::
::::::::::::
|:::::::::::
|:::::::::::
|:::::::::::
|:::::::::::
::::::::::::
|zz:::::::::
|:::::::::::
|:::::::::::
|:::::::::::
|:::::::::::
|::K::::::::
|:::::::::::
|:::::::::::
|ZZZ::::::::
|:k:::::::::
|:::::::::::
|:::::::::::
|:::::::::::
|:::::::::::
|:::#:::::::
|:::#m::::::
|:::::::::::
|:::::::::::
|:::::::::::
|:::::::::::
|zz:::::::::
|:::::::::::
|:::::::::::
|:::::::::::
|b::::::::::
|:::#:::::::
|:::#:::::::
|:::::::::::
|:::::::::::
|:::::::::::
|z::::::::::
|:::::::::::
|b::::::::::
|b::#:::::::
|:::#z::::::
|:::#:::::::
|:::::::::::
|:::::::::::
|:::::::::::
|:::::::::::
|ZZZ::::::::
|:::::::::::
|:::::::::::
|:::::::::::
|:::::::::::
|:::::::::::
|ppe::::::::
|ppe::::::::
|:::::::::::
|:::::::::::
|:::::::::::
|:::::::::::
|::K::::::::
::::::::::::
|:::::::::::
|:::::::::::
|:::::::::::
|ppe::::::::
|ppe::::::::
::::::::::::
|:::::::::::
::::::::::::
|:::::::::::
::::::::::::
::::::::::::
::::::::::::
::::::::::::
::::::::::::
::::::::::::
|:::::::::::
|:::::::::::
|ppppe::::::
|ppppe::::::
|:::::::::::
|:::::::::::
|:::::::::::
|:::::::::::
|:::::::::::
|ppe::::::::
|ppe::::::::
|:::::::::::
|:::::::::::
|:::K:::::::
|:::::::::::
|:::::::::::
|:K:::::::::
|:::::::::::
|:::::::::::
|:::::::::::
:::::K::::::
|zz:::::::::
::::::::::::
::::::::::::
::::::::::::
|:::::::::::
|:::::::::::
|:::::::::::
|=g:::::::::
|==:::::::::
|===g:::::::
|====:::::::
|=====::::::
|:::::::::::
|b::::::::::
|:::::::::::
|:::::::::::
|ZZZ::::::::
|:::::::::::
|:::::::::::
|:::::::::::
|:::::::::::
|:::::::::::
|:::::::::::
|:::::::::::
|=::::::::::
|==:::::::::
|===::::::::
::::::::K:::
|=====::::::
::::::::::::
::::::::::::
|========:::
|========:::
|:::::::::::
|:::::::::::
|:::::::::::
|:::::::::::
|:::::::::::
|:::::::::::
|:::::::::::
|:::::::::f:
|fffffffffff
