0122344444444
0122563444444
0789:23444444
0122;<3444444
0122344444444
0=44444444444
0=44444444444
0=44444444444
0=44444444444
0=44444444444
0=44444444444
0=44444444444
0=44444444444
0=44444444444
0=44444444444
444>?44444444
0=44444444444
0@A4444444444
0@BA444444444
0@BBA44444444
0@BBBA4444CD4
444444EF44GH4
0@BBBBBA444IJ
0@BBBBBBA44KL
0@BBBBBBBA444
0@BBBBBBBA444
0=44444444444
0=44444444444
0=44444444444
0=44MN4444444
0=44MN4444444
0=44MN4444444
0=44MN4444444
0=44444444444
0=44444444444
0=44444444444
4444444444444
0=44444444444
0=44444444444
0=44444444444
0=44444444444
0=44444444444
0=44444444444
0=444444OP444
0QRS4444TUV44
44444444OP444
0=444444OP444
0=444444OP444
0=444444OP444
0=444444OP444
44444444OP444
0=444444OP444
44444444OP444
0=444444OP444
0=44WX44OP444
0=44YZ44OP444
44444444OP444
0=444444OP444
0=444444OP444
0=444444OP444
0=444444OP444
0=444444OP444
0=444444OP444
444[\]44OP444
0=4^_`44OP444
0=444444OP444
0=444444OP444
0=44ab44OP444
0=44cd44OP444
0=444444OP444
0=444444OP444
0=444444OP444
0=444444OP444
0=444444OP444
0=444444OP444
0=444444OP444
0=44444444444
0=44OP4444444
4444OP4444444
4444444444444
0=44444444444
0=44444444444
0=44444444444
0=44444444444
4444444444444
0efg444444444
0=44444444444
0=44444444444
0=44444444444
0=44444444444
0=hij44444444
0=44444444444
0=44444444444
0klfg44444444
0=4mn44444444
0=44444444444
0=44444444444
0=44444444444
0=44444444444
0=44OP4444444
0=44Top444444
0=44444444444
0=44444444444
0=44444444444
0=44444444444
0efg444444444
0=44444444444
0=44444444444
0q44444444444
0=44444444444
0=44OP4444444
0=44OP4444444
0=44444444444
0=44444444444
0=44444444444
0rg4444444444
0=44444444444
0=44444444444
0s44OP4444444
0=44tug444444
0q44Tvwx44444
0=44444444444
0=44444444444
0=44444444444
0=44444444444
0yzfg44444444
0=44444444444
0=44444444444
0=44444444444
0=44444444444
0=44444444444
0{|}~44444444
0ÄÅÇ44444444
0=44444444444
0=44444444444
0=44444444444
0=44444444444
0=4ÉÑ44444444
4444444444444
0=44444444444
0=44444444444
0=44444444444
0{|}~44444444
0ÄÅÇ44444444
4444444444444
0=44444444444
4444444444444
0=44444444444
4444444444444
4444444444444
4444444444444
4444444444444
4444444444444
4444444444444
0=44444444444
0=44444444444
0{ÖÖ|}~444444
0ÜáÄÅÇ444444
0=44444444444
0=44444444444
0=44444444444
0=44444444444
0=44444444444
0{|}~44444444
0àâÅÇ44444444
0=44444444444
0=44ä44444444
0=44ãå4444444
0=44444444444
0=çéè44444444
0=êëí44444444
0=44444444444
0=44444444444
0=44ìîï444444
4444ñó4444444
0efg444444444
4444444444444
4444444444444
4444444444444
0=44444444444
0=44444444444
0=44444444444
0@òô444444444
0@öõ444444444
0@BBòô4444444
0@BBBA4444444
0@BBBBA444444
0=44444444444
0ú44444444444
0=44444444444
0=44444444444
0rlfg44444444
0=44444444444
0=44444444444
0=44444444444
0=44444444444
0=44444444444
0=44444444444
0=44444444444
0@A4444444444
0@BA444444444
0@BBA444ùû444
44444444ü†444
0@BBBBA444444
4444444444444
4444444444444
0@BBBBBBBA444
0@BBBBBBBA444
0=44444444444
0=44444444444
0=44444444444
0=44444444444
0=44444444444
0=44444444444
0=44444444444
0=444444444°4
0@¢£££££££§•4
