322100000000
322541000000
376521000000
322581000000
322100000000
300000000000
300000000000
300000000000
300000000000
300000000000
300000000000
300000000000
300000000000
300000000000
300000000000
000:90000000
300000000000
3;0000000000
3;;000000000
3;;;00000000
3;;;;00000=<
00000BA00@?>
3;;;;;;0000C
3;;;;;;;000D
3;;;;;;;;000
3;;;;;;;;000
300000000000
300000000000
300000000000
3000E0000000
3000E0000000
3000E0000000
3000E0000000
300000000000
300000000000
300000000000
000000000000
300000000000
300000000000
300000000000
300000000000
300000000000
300000000000
30000000F000
3JI00000HG00
00000000F000
30000000F000
30000000F000
30000000F000
30000000F000
00000000F000
30000000F000
00000000F000
30000000F000
300LK000F000
300NM000F000
00000000F000
30000000F000
30000000F000
30000000F000
30000000F000
30000000F000
30000000F000
000PO000F000
300RQ000F000
30000000F000
30000000F000
300TS000F000
300VU000F000
30000000F000
30000000F000
30000000F000
30000000F000
30000000F000
30000000F000
30000000F000
300000000000
3000F0000000
0000F0000000
000000000000
300000000000
300000000000
300000000000
300000000000
000000000000
3XW000000000
300000000000
300000000000
300000000000
300000000000
30ZY00000000
300000000000
300000000000
3[XW00000000
30]\00000000
300000000000
300000000000
300000000000
300000000000
3000F0000000
3000H^000000
300000000000
300000000000
300000000000
300000000000
3XW000000000
300000000000
300000000000
_00000000000
300000000000
3000F0000000
3000F0000000
300000000000
300000000000
300000000000
3W0000000000
300000000000
300000000000
`000F0000000
3000;W000000
_000Hba00000
300000000000
300000000000
300000000000
300000000000
3cXW00000000
300000000000
300000000000
300000000000
300000000000
300000000000
3gfed0000000
3kjih0000000
300000000000
300000000000
300000000000
300000000000
30nml0000000
000000000000
300000000000
300000000000
300000000000
3gfed0000000
3kjih0000000
000000000000
300000000000
000000000000
300000000000
000000000000
000000000000
000000000000
000000000000
000000000000
000000000000
300000000000
300000000000
3gggfed00000
3qpojih00000
300000000000
300000000000
300000000000
300000000000
300000000000
3gfed0000000
3rjih0000000
300000000000
3000s0000000
300ut0000000
300000000000
30wv00000000
30yx00000000
300000000000
300000000000
3000{z000000
0000}|000000
3XW000000000
000000000000
000000000000
000000000000
300000000000
300000000000
300000000000
3;~000000000
3;000000000
3;;;~0000000
3;;;;0000000
3;;;;;000000
300000000000
Ä00000000000
300000000000
300000000000
3WXW00000000
300000000000
300000000000
300000000000
300000000000
300000000000
300000000000
300000000000
3;0000000000
3;;000000000
3;;;0000ÇÅ00
00000000ÑÉ00
3;;;;;000000
000000000000
000000000000
3;;;;;;;;000
3;;;;;;;;000
300000000000
300000000000
300000000000
300000000000
300000000000
300000000000
300000000000
3000000000Ö0
3;âââââââàáÜ
