322100000000
322541000000
376521000000
322581000000
322100000000
300000000000
300000000000
300000000000
300000000000
300000000000
300000000000
300000000000
300000000000
300000000000
300000000000
300000000000
300000000000
300000000000
3:9000000000
300000000000
300000000000
300000000000
300000000000
300000000000
300000000000
300000000000
300000000000
3=<;00000000
3@?>00000000
300000000000
300000000000
300000000000
300000000000
300000000000
3A:900000000
300000000000
300000000000
300000000000
300000000000
300000000000
300000000000
300000000000
300000000000
300000000000
300000000000
300000000000
300000000000
300000000000
300000000000
300000000000
300000000000
300000000000
300000000000
3EEEDCB00000
3IIIHGF00000
300000000000
300000000000
300000000000
300000000000
300000000000
3000J000J000
3000J000J000
3000J000J000
3000JLK0J000
3000JNM0J000
3PO0J000J000
3TS0J000RQ00
3000J000J000
300000000000
000000000000
000000000000
3UUUU0000000
3UUU00000000
3UU000000000
3U0000000000
000000000000
000000000000
300000000000
300000000000
300000000000
300000000000
300000000000
300000000000
300000000000
300000000000
300000000000
3WV000000000
300000000000
300000000000
300000000000
30YX00000000
30[Z00000000
300000000000
300000000000
300000000000
3UUU00000000
300000000000
300000000000
300000000000
300000000000
300000000000
300000000000
300000000000
300000000000
300000000000
300000000000
300000000000
300000000000
300000000000
3UUUU0000000
3UUUU0000000
300000000000
300000000000
300000000000
300000000000
3000J000J000
3000J000R\00
3000J000J000
_^]0J000J000
3000JL`0J000
3000Jba0J000
3000J000J000
3000J000J000
300000000000
000000000000
000000000000
3EEEDCB00000
3IIIHGF00000
000000000000
000000000000
300000000000
300000000000
300000000000
300000000000
300000000000
300000000000
edc000000000
gf0000000000
300000000000
300000000000
300000000000
300000000000
300000000000
300000000000
300000000000
3ih000000000
gj0000000000
300000000000
300000000000
300000000000
300000000000
300000000000
300000000000
300000000000
300000000000
300000000000
300000000000
300000000000
300000000000
300000000000
30lk00000000
300000000000
300000000000
300000000000
300000000000
300000000000
300000000000
300000000000
3EEDCB000000
3IIHGF000000
300000000000
300000000000
300000000000
300000000000
300000000000
300000000000
300000000000
_nm000000000
300000000000
300000000000
300000000000
300000000000
300000000000
300000000000
300000000000
3po000000000
grq000000000
300000000000
300000000000
300000000000
3000uts00000
300000000000
300000000000
300000000000
300000000000
3UU000000000
300000000000
000000000000
00U000000000
000000000000
0000U0000000
000000000000
000000U00000
000000000000
00000000U000
00000000U000
000000000000
000000000000
300000000000
300000000000
300000000000
300000000000
300000000000
3yxw000000v0
3U}}}}}}}|{z
