0122344444444
0122563444444
0789:23444444
0122;<3444444
0122344444444
0=44444444444
0=44444444444
0=44444444444
0=44444444444
0=44444444444
0=44444444444
0=44444444444
0=44444444444
0=44444444444
0=44444444444
0=44444444444
0=44444444444
0=44444444444
0>?@444444444
0=44444444444
0=44444444444
0=44444444444
0=44444444444
0=44444444444
0=44444444444
0=44444444444
0=44444444444
0=AB444444444
0=CD444444444
0=44444444444
0=44444444444
0=44444444444
0=44444444444
0=44444444444
0EF?@44444444
0=44444444444
0=44444444444
0=44444444444
0=44444444444
0=44444444444
0=44444444444
0=44444444444
0=44444444444
0=44444444444
0=44444444444
0=44444444444
0=44444444444
0=44444444444
0=44444444444
0=44444444444
0=44444444444
0=44444444444
0=44444444444
0GHHIJK444444
0LMMNOP444444
0=44444444444
0=44444444444
0=44444444444
0=44444444444
0=44444444444
0=44QR44QR444
0=44QR44QR444
0=44QR44QR444
0=44QRS4QR444
0=44QTU4QR444
0VWXQR44QR444
0YZ4QR44[\]44
0=44QR44QR444
0=44444444444
4444444444444
4444444444444
0^___`4444444
0^__`44444444
0^_`444444444
0^`4444444444
4444444444444
4444444444444
0=44444444444
0=44444444444
0=44444444444
0=44444444444
0=44444444444
0=44444444444
0=44444444444
0=44444444444
0=44444444444
0abc444444444
0=44444444444
0=44444444444
0=44444444444
0=4de44444444
0=fgh44444444
0=44444444444
0=44444444444
0=44444444444
0^__`44444444
0=44444444444
0=44444444444
0=44444444444
0=44444444444
0=44444444444
0=44444444444
0=44444444444
0=44444444444
0=44444444444
0=44444444444
0=44444444444
0=44444444444
0=44444444444
0^___`4444444
0^___`4444444
0=44444444444
0=44444444444
0=44444444444
0=44444444444
0=44QR44QR444
0=44QR44[\i44
0=44QR44QR444
0jk4QR44QR444
0=44QRl4QR444
0=44Qmn4QR444
0=44QR44QR444
0=44QR44QR444
0=44444444444
4444444444444
4444444444444
0GHHIJK444444
0LMMNOP444444
4444444444444
4444444444444
0=44444444444
0=44444444444
0=44444444444
0=44444444444
0=44444444444
0=44444444444
0op4444444444
0qr4444444444
0=44444444444
0=44444444444
0=44444444444
0=44444444444
0=44444444444
0=44444444444
0=44444444444
0st4444444444
0uv4444444444
0=44444444444
0=44444444444
0=44444444444
0=44444444444
0=44444444444
0=44444444444
0=44444444444
0=44444444444
0=44444444444
0=44444444444
0=44444444444
0=44444444444
0=44444444444
0=wxy44444444
0=44444444444
0=44444444444
0=44444444444
0=44444444444
0=44444444444
0=44444444444
0=44444444444
0GHIJK4444444
0LMNOP4444444
0=44444444444
0=44444444444
0=44444444444
0=44444444444
0=44444444444
0=44444444444
0=44444444444
0z{4444444444
0=44444444444
0=44444444444
0=44444444444
0=44444444444
0=44444444444
0=44444444444
0=44444444444
0|}4444444444
0~4444444444
0=44444444444
0=44444444444
0=44444444444
0=44ÄÅÇÉ44444
0=44444444444
0=44444444444
0=44444444444
0=44444444444
0^_`444444444
0=44444444444
4444444444444
44Ñ`444444444
4444444444444
4444Ñ`4444444
4444444444444
444444Ñ`44444
4444444444444
44444444Ñ`444
44444444Ñ`444
4444444444444
4444444444444
0=44444444444
0=44444444444
0=44444444444
0=44444444444
0=44444444444
0ÖÜáà444444â4
0^äãããããããåç4
