|:::::::::::
|:::::::::::
|:::::::::::
|:::::::::::
|:::::::::::
|:::::::::::
|ppe::::::::
|ppe::::::::
|:::::::::::
|:::::::::::
|ppe::::::::
|ppe::::::::
|:::::::::::
|:::::::::::
|:::::::::::
|:::::::::::
|:::::::::::
|:::::::::::
|:::::::::::
|:::::::::::
|:::::::::::
|:::::::::::
|b::::::::::
|:::::::::::
|:::::::::::
|:::::::::::
|:::::::::::
|:::::::::::
|:::::::::::
|:::::::::::
|:::::::::::
|:::::::::::
|ppe::::::::
|ppe::::::::
|:::::::::::
|:::#:::#:::
|:::#:::#:::
|:::#h::#:::
|:::#:::#:::
|h::#:::#m::
|:::#:::#:::
|:::::::::::
::::::::::::
|:::::::::::
|:::::::::::
|:::::::::::
|:::::::::::
|pppe:::::::
|pppe:::::::
::::::::::::
::::::::::::
::::::::::::
::::::::::::
|:::::::::::
|:::::::::::
|:::::::::::
|:::::::::::
|:::::::::::
|:::::::::::
|:::::::::::
|ZZZ::::::::
|:::::::::::
|:::::::::::
|:::::::::::
|:::::::::::
|:::::::::::
|:::::::::::
|:::::::::::
|:::::::::::
|:::::::#:::
|SS:::::#m::
::::::::#:::
|:::::::#:::
|:::::::#:::
|:::::::#:::
|:::::::#:::
|:::::::#:::
|:::::::#:::
|:::::::#:::
|:::::::#:::
|:::K:::#:::
::::::::#:::
|:::::::#:::
::::::::#:::
::::::::#:::
::::::::#:::
::::::::#:::
::::::::#:::
::::::::::::
|:::::::::::
|:::::::::::
|:::::::::::
|:::::::::::
|:::::::::::
|:::::::::::
|:::::::::::
|:::::::::::
|:::::::::::
|:::::::::::
|:::::::::::
|:::::::::::
|:::::::::::
|:::::::::::
|:::::::::::
|:::::::::::
|:::::::::::
|:::::::::::
|:::::::::::
|:::::::::::
|pppe:::::::
|pppe:::::::
|:::::::::::
|:::::::::::
|:::::::::::
|g::::::::::
|g::::::::::
|g::::::::::
|g::::::::::
|g::::::::::
|:::::::::::
|:::::::::::
|:::::::::::
|:::::::::::
|:::::::::::
|:::::::::::
|:::::::::::
|:::::::::::
|:::::::::::
|:::::::::::
|:::::::::::
|:::::::::::
|:::::::::::
|:::::::::::
|:::::::::::
|:::::::::::
|:::?:::::::
|:::::::::::
|:::::::::::
|:::::::::::
|:::::::::::
|:::::::::::
|:::::::::::
|:::::::::::
|:::::::::::
|g::::::::::
|:::::::::::
|:::::::::::
|:::::::::::
|:::::::::::
|:::::::::::
|:::::::::::
|ppe::::::::
|ppe::::::::
|:::::::::::
|:::::::::::
|pppp:::::::
|pppp:::::::
|:::::::::::
|:::::::::::
|:::::::::::
|zz:::::::::
|:::::::::::
|:k:::::::::
|:::::::::::
|:::::::::::
|g::::::::::
|g::::::::::
|:::::::::::
|=::::::::::
|==:::::::::
|===::::::::
|====:::::::
|:::=:::::::
|:::=zz:::::
|:::=:::::::
|:::::::::::
|k::::::::::
|:::::::::::
|:::::::::::
|:::::::::::
|:::::::::::
|:::::::::::
|:::::::::::
|:::#:::#:::
|:::#:::#m::
|:::::::::::
|:::::::::::
|:::::::::::
|:::::::::::
|ppppe::::::
|ppppe::::::
|:::::::::::
|:::::::::::
|:::::::::::
|:::::::::::
|:::::::::f:
|fffffffffff