|,:,:,:,:,:,:,:,:,:,:,:
|,:,:,:,:,:,:,:,:,:,:,:
|,:,:,:,:,:,:,:,:,:,:,:
|,:,:,:,:,:,:,:,:,:,:,:
|,:,:,:,:,:,:,:,:,:,:,:
|,:,:,:,:,:,:,:,:,:,:,:
|,:,:,:,:,:,:,:,:,:,:,:
:,:,:,:,:,:,:,:,:,:,:,:
T,:,:,:,:,:,:,:,:,:,:,:
T,:,:,:,:,:,:,:,:,:,:,:
T,=,:,:,:,:,:,:,:,:,:,:
T,=,=,:,:,:,:,:,:,:,:,:
T,=,=,=,:,:,:,:,:,:,:,:
T,=,=,=,:,:,:,:,:,:,:,:
T,=,=,=,:,:,:,:,:,:,:,:
T,:,:,w,:,:,:,:,:,:,:,:
:,C,:,w,:,:,:,:,:,:,:,:
:,:,:,w,:,:,:,:,:,:,:,:
:,:,:,w,:,:,:,:,:,:,:,:
:,:,:,w,:,:,:,:,:,:,:,:
:,:,:,w,:,:,:,:,:,:,:,:
:,:,:,w,:,:,:,:,:,:,:,:
:,:,:,w,:,:,:,:,:,:,:,:
:,:,:,w,:,:,:,:,:,:,:,:
:,:,:,w,:,:,:,:,:,:,:,:
:,:,:,w,:,:,:,:,:,:,:,:
:,:,:,w,:,:,:,:,:,:,:,:
:,:,:,w,:,:,:,:,C,:,:,:
:,:,:,w,:,:,:,:,:,:,:,:
:,:,:,w,:,:,:,:,:,:,:,:
:,:,:,w,:,:,:,:,:,:,:,:
=,=,=,=,:,:,:,:,:,:,:,:
:,:,:,w,:,:,:,:,:,:,:,:
:,:,:,w,:,:,:,:,:,:,:,:
:,:,:,w,:,:,:,:,:,:,:,:
:,C,:,w,:,:,:,:,:,:,:,:
:,:,:,w,:,:,:,:,c,:,:,:
:,:,:,w,:,:,:,:,c,:,:,:
:,:,:,w,:,:,:,:,c,:,:,:
:,:,:,w,:,:,:,:,c,:,:,:
:,:,:,w,:,:,:,:,:,:,:,:
:,:,:,w,:,:,:,:,:,:,:,:
:,:,:,w,:,:,:,:,:,:,:,:
:,:,:,w,:,:,:,:,:,:,:,:
:,:,:,w,:,:,:,:,:,:,:,:
:,:,:,w,:,:,:,:,:,:,:,:
:,:,:,w,:,:,:,:,:,:,:,:
=,=,=,=,:,:,:,:,:,:,:,:
:,:,:,w,:,C,:,:,:,:,:,:
:,:,:,w,:,:,:,:,:,:,:,:
:,:,:,w,:,:,:,:,:,:,:,:
:,:,:,w,:,:,:,:,:,:,:,:
:,:,:,w,:,:,:,:,:,:,:,:
:,:,:,w,:,:,:,:,:,:,:,:
:,:,:,w,:,:,:,:,:,:,:,:
:,:,:,w,:,:,:,:,c,:,:,:
:,:,:,w,:,:,:,c,:,:,:,:
C,:,:,w,:,:,:,:,c,:,:,:
:,:,:,w,:,:,:,c,:,:,:,:
:,:,:,w,:,:,:,:,c,:,:,:
:,:,:,w,:,:,:,:,:,:,:,:
:,:,:,w,:,:,:,:,:,:,:,:
:,:,:,w,:,:,:,:,C,:,:,:
=,=,=,=,:,:,:,:,:,:,:,:
:,:,:,:,:,:,:,:,:,:,:,:
:,:,:,:,:,:,:,:,:,:,:,:
:,:,:,:,:,:,:,:,:,:,:,:
:,:,:,:,:,:,:,:,:,:,:,:
=,=,=,=,:,:,:,:,:,:,:,:
:,:,:,w,:,C,:,:,:,:,:,:
:,:,:,w,:,:,:,:,:,:,:,:
:,:,:,w,:,:,:,:,:,:,:,:
:,:,:,w,:,:,:,:,c,:,:,:
:,:,:,w,:,:,:,:,:,c,:,:
:,:,:,w,:,:,:,:,:,c,:,:
:,:,:,w,:,:,:,:,c,:,:,:
:,:,:,w,:,:,:,:,:,:,:,:
:,:,:,w,:,:,:,:,:,:,:,:
:,:,:,w,:,:,:,:,:,:,:,:
=,=,=,=,:,:,:,:,:,:,:,:
:,:,:,:,:,:,:,:,:,:,:,:
:,:,:,:,:,:,:,:,:,:,:,:
:,:,:,:,:,:,:,:,C,:,:,:
:,:,:,:,:,:,:,:,:,:,:,:
=,=,=,=,:,:,:,:,:,:,:,:
:,:,:,w,:,:,:,:,:,:,:,:
:,:,:,w,:,:,:,:,:,:,:,:
:,:,:,w,:,:,:,:,:,:,:,:
:,:,:,w,:,:,:,:,:,:,:,:
C,:,:,w,:,:,:,:,:,:,:,:
:,:,:,w,:,:,:,:,:,:,:,:
:,:,:,w,:,:,:,:,:,:,:,:
:,:,:,w,:,:,:,:,:,:,:,:
:,:,:,w,:,:,:,:,:,:,:,:
:,:,:,w,:,:,:,:,:,:,:,:
=,=,=,=,:,:,:,:,:,:,:,:
:,:,:,:,:,:,:,:,:,:,:,:
:,:,:,:,:,:,C,:,c,:,:,:
:,:,:,:,:,:,:,:,c,:,:,:
=,=,=,=,=,:,:,:,c,:,:,:
:,:,:,:,w,:,:,:,:,:,:,:
:,:,:,:,w,:,:,:,:,:,:,:
:,:,:,:,w,:,:,:,?,:,:,:
:,:,:,:,w,:,:,:,:,:,:,:
:,:,:,:,w,:,:,:,:,:,:,:
=,=,=,=,=,:,:,:,:,:,:,:
:,:,C,:,:,:,:,:,:,:,:,:
:,:,:,:,:,:,:,:,:,:,:,:
:,:,:,:,:,:,:,:,c,:,:,:
:,:,:,:,:,:,:,:,c,:,:,:
:,:,:,:,:,:,:,:,c,:,:,:
:,:,:,:,:,:,:,:,:,:,:,:
T,:,:,:,:,:,:,:,:,:,:,:
T,:,:,C,:,:,:,:,:,:,:,:
T,:,:,:,:,:,:,:,:,:,:,:
T,:,:,:,:,:,:,:,:,:,:,:
T,:,:,:,:,:,:,:,:,:,:,:
T,:,:,:,:,:,:,:,:,:,:,:
T,:,:,:,:,:,:,:,:,:,:,:
T,:,:,:,:,:,:,:,:,:,:,:
:,:,:,:,:,:,:,:,:,:,:,:
:,:,:,:,:,:,:,:,:,:,:,:
:,:,:,w,:,:,:,:,:,:,:,:
:,:,:,w,:,:,:,:,:,:,:,:
:,:,:,w,:,:,:,C,:,:,:,:
:,:,:,:,:,:,:,:,:,:,:,:
:,:,:,:,:,:,:,:,:,:,:,:
=,=,=,=,:,:,:,:,:,:,:,:
:,:,:,w,:,:,:,:,:,:,:,:
:,:,:,w,:,:,:,:,:,:,:,:
:,:,:,w,:,:,:,:,:,:,:,:
:,:,:,w,:,:,:,:,:,:,:,:
:,:,:,w,:,:,:,:,:,:,:,:
:,:,:,w,:,:,:,:,c,:,:,:
:,:,:,w,:,:,:,:,c,:,:,:
:,:,:,w,:,:,:,:,c,:,:,:
:,C,:,w,:,:,:,:,c,:,:,:
:,:,:,w,:,:,:,:,c,:,:,:
:,:,:,w,:,:,:,:,c,:,:,:
:,:,:,w,:,:,:,:,:,:,:,:
:,:,:,w,:,:,:,C,:,:,:,:
:,:,:,w,:,:,:,:,:,:,:,:
:,:,:,w,:,:,:,:,:,:,:,:
=,=,=,=,:,:,:,:,:,:,:,:
:,:,:,:,:,:,:,:,:,:,:,:
:,:,:,:,:,:,:,:,:,:,:,:
=,=,:,:,:,:,:,:,:,:,:,:
:,w,:,:,:,:,:,:,:,:,:,:
:,w,:,:,:,:,:,:,:,:,:,:
:,w,:,:,:,c,:,:,:,:,:,:
:,w,:,:,:,c,:,:,:,:,:,:
:,w,:,:,:,c,:,:,:,:,:,:
:,w,:,:,:,c,:,C,:,:,:,:
:,w,:,:,:,:,:,:,:,:,:,:
:,w,:,:,:,:,:,:,:,:,:,:
=,=,:,:,:,:,:,:,:,:,:,:
:,:,:,:,:,:,:,:,:,:,:,:
:,:,:,:,:,:,:,:,:,:,:,:
:,:,:,:,:,:,:,:,:,:,:,:
=,=,=,=,:,:,:,:,:,:,:,:
:,:,:,w,:,:,:,:,:,:,:,:
:,:,:,w,:,:,:,:,:,:,:,:
:,:,:,w,:,:,:,:,:,:,:,:
:,C,:,w,:,:,:,:,:,:,:,:
:,:,:,w,:,:,:,:,:,:,:,:
:,:,:,w,:,:,:,:,:,:,:,:
:,:,:,w,:,:,:,:,:,:,:,:
:,:,:,w,:,:,:,:,:,:,:,:
=,=,=,=,:,:,:,:,:,:,:,:
:,:,:,:,:,:,:,:,:,:,:,:
:,:,:,:,:,:,:,:,:,:,:,:
:,:,:,w,:,:,:,:,:,:,:,:
:,:,:,w,:,:,:,:,:,:,:,:
:,:,:,:,:,:,:,c,:,:,:,:
:,:,:,:,:,:,:,c,:,:,:,:
:,:,:,w,:,C,:,c,:,:,:,:
:,:,:,w,:,:,:,c,:,:,:,:
:,:,:,:,:,:,:,c,:,:,:,:
:,:,:,:,:,:,:,:,:,:,:,:
:,:,:,w,:,:,:,:,:,:,:,:
:,:,:,w,:,:,:,:,:,:,:,:
:,:,:,:,:,:,:,:,:,:,:,:
:,:,:,:,:,:,:,:,:,:,:,:
=,=,=,=,:,:,:,:,:,:,:,:
:,:,:,w,:,:,:,:,:,:,:,:
:,C,:,w,:,:,:,:,C,:,:,:
:,:,:,w,:,:,:,:,:,:,:,:
:,:,:,w,:,:,:,:,:,:,:,:
:,:,:,w,:,:,:,:,:,:,:,:
:,:,:,w,:,:,:,:,:,:,:,:
:,:,:,w,:,:,:,:,:,:,:,:
:,:,:,w,:,:,:,:,:,:,:,:
T,:,:,w,:,:,:,:,:,:,:,:
T,=,=,=,:,:,:,:,:,:,:,:
T,=,=,=,:,:,:,:,:,:,:,:
T,=,=,:,:,:,:,:,:,:,:,:
T,=,:,:,:,:,:,:,:,:,:,:
T,:,:,:,:,:,:,:,:,:,:,:
T,:,:,:,:,:,:,:,:,:,:,:
T,:,:,:,:,:,:,:,:,:,:,:
T,:,:,:,:,:,:,:,:,:,:,:
T,:,:,:,:,:,:,:,:,:,:,:
T,:,:,:,:,:,:,:,:,:,:,:
T,:,:,:,:,:,:,:,:,:,:,:
T,:,:,:,:,:,:,:,:,:,:,:
:,:,:,:,:,:,:,:,:,:,:,:
:,:,:,:,:,:,:,:,:,:,:,:
|,:,:,:,:,:,:,:,:,:,:,:
|,=,:,:,:,:,:,:,:,:,:,:
|,=,=,:,:,:,:,:,:,:,:,:
|,=,=,=,:,:,:,:,:,:,:,:
|,=,=,=,=,:,:,:,:,:,:,:
|,=,=,=,=,=,:,:,:,:,:,:
|,=,=,=,=,=,=,:,:,:,:,:
|,=,=,=,=,=,=,=,:,:,:,:
|,=,=,=,=,=,=,=,=,:,:,:
|,=,=,=,=,=,=,=,=,:,:,:
|,:,:,:,:,:,:,:,:,:,:,:
|,:,:,:,:,:,:,:,:,:,:,:
|,:,:,:,:,:,:,:,:,:,:,:
|,:,:,:,:,:,:,:,:,:,:,:
|,:,:,:,:,:,:,:,:,:,:,:
|,:,:,:,:,:,:,:,:,:,:,:
|,:,:,:,:,:,:,:,:,:,:,:
|,:,:,:,:,:,:,:,:,:,f,:
|,f,f,f,f,f,f,f,f,f,f,f
