|,:,:,:,:,:,:,:,:,:,:,:
|,:,:,:,:,:,:,:,:,:,:,:
|,:,:,:,:,:,:,:,:,:,:,:
|,:,:,:,:,:,:,:,:,:,:,:
|,:,:,:,:,:,:,:,:,:,:,:
|,:,:,:,:,:,:,:,:,:,:,:
|,:,:,:,:,:,:,:,:,:,:,:
|,:,:,:,:,:,:,:,:,:,:,:
|,:,:,:,:,:,:,:,:,:,:,:
|,:,:,:,:,:,:,:,:,:,:,:
|,:,:,:,:,:,:,:,:,:,:,:
|,:,:,:,:,:,:,:,:,:,:,:
|,:,:,:,:,:,:,:,:,:,:,:
|,:,:,:,:,:,:,:,:,:,:,:
|,:,:,:,:,:,:,:,:,:,:,:
|,:,:,:,:,:,:,:,:,:,:,:
|,:,:,:,:,:,:,:,:,:,:,:
|,:,:,:,:,:,:,:,:,:,:,:
|,:,:,:,:,:,:,:,:,:,:,:
|,:,:,:,:,:,:,:,:,:,:,:
|,:,:,:,:,:,:,:,:,:,:,:
|,p,p,p,e,:,:,:,:,:,:,:
|,p,p,p,e,:,:,:,:,:,:,:
|,:,:,:,:,:,:,:,:,:,:,:
|,:,:,:,:,:,:,:,:,:,:,:
|,:,:,:,?,:,:,:,?,:,:,:
|,:,:,:,:,:,:,:,:,:,:,:
|,r,:,:,:,:,:,:,:,:,:,:
|,:,:,:,:,:,:,:,:,:,:,:
|,:,:,:,:,:,:,:,:,:,:,:
|,:,:,:,:,:,:,R,:,:,:,:
|,:,:,:,:,:,:,:,:,:,:,:
:,:,:,:,:,:,:,:,:,:,:,:
:,:,:,:,:,:,:,:,:,:,L,:
|,:,:,:,:,:,:,:,:,:,:,:
|,:,:,:,:,:,:,:,:,:,:,:
|,:,:,:,:,:,:,:,:,:,:,:
|,:,:,:,:,:,:,:,:,:,:,:
|,:,:,:,:,:,:,:,:,:,:,:
|,:,:,:,:,:,:,:,:,:,:,:
|,:,:,:,:,:,:,:,:,:,:,:
|,:,:,:,c,:,:,:,:,:,:,:
|,:,:,:,:,c,:,:,:,:,:,:
|,:,:,:,:,c,:,:,:,:,:,:
|,:,:,:,c,:,:,:,:,:,:,:
|,:,:,:,:,:,:,:,:,:,:,:
|,:,:,:,:,:,:,:,:,:,:,:
|,:,:,:,:,:,:,:,:,:,:,:
|,:,:,:,:,:,:,:,:,:,:,:
|,:,:,:,:,:,:,:,:,:,:,:
|,:,:,:,:,:,:,:,:,:,:,:
|,:,:,:,:,:,:,:,:,:,:,:
|,:,:,:,:,:,:,:,:,:,:,:
|,:,:,:,:,:,:,:,:,:,:,:
|,:,:,:,:,:,:,:,:,:,:,:
|,:,:,:,:,:,:,:,:,:,:,:
|,:,:,:,:,:,:,:,:,:,:,:
|,:,:,:,:,:,:,:,:,:,:,:
|,:,:,:,:,:,:,:,:,:,:,:
|,:,:,:,:,:,:,:,:,:,:,:
|,:,:,:,:,:,:,:,:,:,:,:
|,:,:,:,:,:,:,:,:,:,:,:
|,:,:,:,:,:,:,:,:,:,:,:
|,:,:,:,:,:,:,:,:,:,:,:
|,:,:,:,?,:,:,:,?,:,:,:
|,:,:,:,:,:,:,:,:,:,:,:
|,:,:,:,?,:,:,:,?,:,:,:
|,:,:,:,:,:,:,:,:,:,:,:
|,:,:,:,:,:,:,:,:,:,:,:
|,:,:,:,:,:,:,:,:,:,:,:
|,:,:,:,:,:,:,:,:,:,:,:
|,:,:,:,:,:,:,:,:,:,:,:
|,:,:,:,:,:,:,:,:,:,:,:
|,:,:,:,:,:,:,:,:,:,:,:
|,:,:,:,:,:,:,:,:,:,:,:
|,:,:,:,:,:,:,:,:,:,:,:
|,:,:,:,:,:,:,:,:,:,:,:
|,:,:,:,:,:,:,:,:,:,:,:
:,:,:,:,:,:,:,:,:,:,:,:
:,:,:,:,:,:,:,:,:,:,:,:
:,:,:,:,:,:,:,:,:,:,:,:
:,:,:,:,:,:,:,:,:,:,:,:
|,:,:,:,:,:,:,:,:,:,:,:
|,:,:,:,:,:,:,:,:,:,:,:
|,:,:,:,:,:,:,:,:,:,:,:
|,:,:,:,:,:,:,:,:,:,:,:
|,:,:,:,:,:,:,:,:,:,:,:
|,:,:,:,:,:,:,:,:,:,:,:
|,:,:,:,:,:,:,:,:,:,:,:
|,:,:,:,:,:,:,:,:,:,:,:
|,:,:,:,?,:,:,:,:,:,:,:
|,:,:,:,?,:,:,:,:,:,:,:
|,:,:,:,?,:,:,:,#,m,:,:
|,:,:,:,?,:,:,:,:,:,:,:
|,:,:,:,:,:,:,:,:,:,:,:
|,:,:,:,:,:,:,:,:,:,:,:
|,:,:,:,:,:,:,:,:,:,:,:
|,:,:,:,:,:,:,:,:,:,:,:
|,:,:,:,:,:,:,:,:,:,:,:
|,:,:,:,:,:,:,:,:,:,:,:
|,:,:,:,:,:,:,:,:,:,:,:
|,:,:,:,:,:,:,:,:,:,:,:
|,:,:,:,:,:,:,:,:,:,:,:
|,=,=,=,:,:,:,:,:,:,:,:
|,:,:,:,:,:,:,:,:,:,:,:
|,:,:,:,:,:,:,c,:,:,:,:
|,:,:,:,:,:,:,c,:,:,:,:
|,:,:,:,:,:,:,c,:,:,:,:
|,:,:,:,:,:,:,c,:,:,:,:
|,:,:,:,:,:,:,:,:,:,:,:
|,:,:,:,:,:,:,:,:,:,:,:
|,:,:,:,:,:,:,:,:,:,:,:
|,:,:,:,:,:,:,:,:,:,:,:
|,:,:,:,:,:,:,:,:,:,:,:
|,:,:,:,:,:,:,:,:,:,:,:
|,:,:,:,:,:,:,:,:,:,:,:
|,p,p,p,p,e,:,:,:,:,:,:
|,p,p,p,p,e,:,:,:,:,:,:
|,:,:,:,:,:,:,:,:,:,:,:
|,:,:,:,:,:,:,c,:,:,:,:
|,:,:,:,:,:,:,c,:,:,:,:
|,:,:,:,:,:,:,c,:,:,:,:
|,:,:,:,:,:,:,c,:,:,:,:
|,:,:,:,:,:,:,:,:,:,:,:
|,:,:,:,:,:,:,:,:,:,:,:
|,:,:,:,:,:,:,:,:,:,:,:
|,:,:,:,:,:,:,:,:,:,:,:
|,:,:,:,:,:,:,:,:,:,:,:
|,:,:,:,:,:,:,:,:,:,:,:
|,:,:,:,:,:,:,:,:,:,:,:
|,:,:,:,:,:,:,:,:,:,:,:
|,:,:,:,:,:,:,:,:,:,:,:
|,p,p,p,p,e,:,:,:,:,:,:
|,p,p,p,p,e,:,:,:,:,:,:
|,:,:,:,:,:,:,:,:,:,:,:
|,:,:,:,:,:,:,c,:,:,:,:
|,:,:,:,:,:,:,c,:,:,:,:
|,:,:,:,:,:,:,c,:,:,:,:
|,:,:,:,:,:,:,c,:,:,:,:
|,:,:,:,:,:,:,:,:,:,:,:
|,:,:,:,:,:,:,:,:,:,:,:
|,:,:,:,:,:,:,:,:,:,:,:
|,:,:,:,:,:,:,:,:,:,:,:
|,:,:,:,:,:,:,:,:,:,:,:
|,:,:,:,:,:,:,:,:,:,:,:
|,:,:,:,:,:,:,:,:,:,:,:
|,:,:,:,?,:,:,:,:,:,:,:
|,:,:,:,?,:,:,:,:,:,:,:
|,:,:,:,?,:,:,:,?,:,:,:
:,:,:,:,#,:,:,:,?,:,:,:
:,:,:,:,#,:,:,:,?,:,:,:
|,:,:,:,?,:,:,:,?,:,:,:
|,:,:,:,?,:,:,:,:,:,:,:
|,:,:,:,?,:,:,:,:,:,:,:
|,:,:,:,:,:,:,:,:,:,:,:
|,:,:,:,:,:,:,:,:,:,:,:
|,:,:,:,:,:,:,:,:,:,:,:
|,:,:,:,:,:,:,:,:,:,:,:
|,:,:,:,:,:,:,:,:,:,:,:
|,:,:,:,:,:,:,:,:,:,:,:
|,:,:,:,:,:,:,:,:,:,:,:
|,:,:,:,:,:,:,:,:,:,:,:
|,:,:,:,:,:,:,:,:,:,:,:
|,p,p,e,:,:,:,:,:,:,:,:
|,p,p,e,:,:,:,:,:,:,:,:
|,:,:,:,:,:,:,:,:,:,:,:
|,:,:,:,:,:,:,:,:,:,:,:
|,:,:,:,:,:,:,:,:,:,:,:
|,:,:,:,:,:,:,:,:,:,:,:
|,:,:,:,:,:,:,:,:,:,:,:
|,:,:,:,:,:,:,:,:,:,:,:
|,:,:,:,:,:,:,:,:,:,:,:
|,:,:,:,:,:,:,:,:,:,:,:
|,:,:,:,:,:,:,:,:,:,:,:
:,:,:,:,:,:,:,:,:,:,:,:
:,:,:,:,:,:,:,:,:,:,:,:
:,:,:,:,:,:,:,:,:,:,:,:
|,:,:,:,:,:,:,:,:,:,:,:
|,:,:,:,:,:,:,:,:,:,:,:
|,:,:,:,:,:,:,:,:,:,:,:
:,:,:,:,:,:,:,:,:,:,:,:
:,:,:,:,:,:,:,:,:,:,:,:
|,:,:,:,:,:,:,:,:,:,:,:
|,:,:,:,:,:,:,:,:,:,:,:
|,:,:,:,:,:,:,:,:,:,:,:
|,:,:,:,:,:,:,:,:,:,:,:
|,:,:,:,:,:,:,:,:,:,:,:
|,:,:,:,:,:,:,:,:,:,:,:
|,:,:,:,:,:,:,:,:,:,:,:
|,=,=,=,:,:,:,:,:,:,:,:
:,:,:,:,:,:,:,:,:,:,:,:
:,:,:,:,:,:,:,:,:,:,:,:
|,:,:,:,:,:,:,:,:,:,:,:
|,:,:,:,:,:,:,:,:,:,:,:
|,:,:,:,:,:,:,:,:,:,:,:
|,:,:,:,:,:,:,:,:,:,:,:
|,:,:,:,:,:,:,:,:,:,:,:
|,:,:,:,:,:,:,:,:,:,:,:
|,:,:,:,:,:,:,:,:,:,:,:
|,:,:,:,:,:,:,:,:,:,:,:
|,:,:,:,:,:,:,:,:,:,:,:
|,:,:,:,:,:,:,:,:,:,:,:
|,:,:,:,:,:,:,:,:,:,:,:
|,:,:,:,:,:,:,:,:,:,:,:
|,:,:,:,:,:,:,:,:,:,:,:
|,:,:,:,:,:,:,:,:,:,:,:
|,:,:,:,:,:,:,:,:,:,:,:
|,:,:,:,:,:,:,:,:,:,:,:
|,=,:,:,:,:,:,:,:,:,:,:
|,=,=,:,:,:,:,:,:,:,:,:
|,=,=,=,:,:,:,:,:,:,:,:
|,=,=,=,=,:,:,:,:,:,:,:
|,=,=,=,=,=,:,:,:,:,:,:
|,=,=,=,=,=,=,:,:,:,:,:
|,=,=,=,=,=,=,=,:,:,:,:
|,=,=,=,=,=,=,=,=,:,:,:
|,=,=,=,=,=,=,=,=,:,:,:
|,:,:,:,:,:,:,:,:,:,:,:
|,:,:,:,:,:,:,:,:,:,:,:
|,:,:,:,:,:,:,:,:,:,:,:
|,:,:,:,#,:,:,:,:,:,:,:
|,:,:,:,:,:,:,:,:,:,:,:
|,:,:,:,:,:,:,:,:,:,:,:
|,:,:,:,:,:,:,:,:,:,:,:
|,:,:,:,:,:,:,:,:,:,f,:
|,f,f,f,f,f,f,f,f,f,f,f
