|,:,:,:,:,:,:,:,:,:,:,:
|,:,:,:,:,:,:,:,:,:,:,:
|,:,:,:,:,:,:,:,:,:,:,:
|,:,:,:,:,:,:,:,:,:,:,:
|,:,:,:,:,:,:,:,:,:,:,:
|,:,:,:,:,:,:,:,:,:,:,:
|,:,:,:,:,:,:,:,:,:,:,:
|,:,:,:,:,:,:,:,:,:,:,:
|,:,:,:,:,:,:,:,:,:,:,:
|,:,:,:,:,:,:,:,:,:,:,:
|,:,:,:,:,:,:,:,:,:,:,:
|,:,:,:,:,:,:,:,:,:,:,:
|,=,:,:,:,:,:,:,:,:,:,:
|,=,=,:,:,:,:,:,:,:,:,:
|,=,=,=,:,:,:,:,:,:,:,:
|,=,=,=,=,:,:,:,:,:,:,:
|,:,:,:,=,:,:,:,:,:,:,:
|,:,:,:,=,z,z,:,:,:,:,:
|,:,:,:,=,:,:,:,:,:,:,:
|,:,:,:,:,:,:,:,:,:,:,:
|,k,:,:,:,:,:,:,:,:,:,:
|,:,:,:,:,:,:,:,:,c,:,:
|,:,:,:,:,:,:,:,:,c,:,:
|,:,:,:,:,:,:,:,:,c,:,:
|,:,:,:,:,:,:,:,:,:,:,:
|,S,S,:,:,:,:,:,:,:,:,:
:,:,:,:,:,:,:,:,:,:,:,:
:,:,:,:,:,:,:,:,:,:,:,:
:,:,:,:,:,:,:,:,:,:,:,:
|,:,:,:,#,c,:,:,#,:,:,:
|,:,:,:,#,c,:,:,#,:,:,:
|,:,:,:,#,c,:,:,#,:,:,:
|,:,:,:,#,:,:,:,#,:,:,:
|,:,:,:,#,:,:,:,#,:,:,:
|,:,:,:,#,:,:,:,#,m,:,:
|,:,:,:,:,:,:,:,:,:,:,:
|,:,:,:,:,:,:,:,:,:,:,:
|,:,:,:,:,:,:,:,:,:,:,:
|,:,:,:,K,:,:,:,:,:,:,:
|,:,:,:,:,:,:,:,:,:,:,:
|,:,:,:,:,:,:,:,:,:,:,:
|,:,:,:,:,:,:,:,:,:,:,:
|,:,:,:,:,:,:,:,:,:,:,:
|,:,:,:,:,:,:,:,:,:,:,:
|,=,:,:,:,:,:,:,:,:,:,:
|,=,=,h,:,:,:,:,:,:,:,:
|,=,=,=,:,:,:,:,:,:,:,:
|,=,=,=,=,:,:,:,:,:,:,:
|,=,=,=,=,:,:,:,:,:,:,:
|,=,=,:,:,:,:,:,:,:,:,:
|,:,:,:,:,:,:,:,:,:,:,:
|,:,:,:,:,:,:,:,:,:,:,:
|,:,:,:,:,:,:,:,:,:,:,:
|,:,:,:,:,:,:,:,:,:,:,:
|,:,:,:,:,:,:,:,:,:,:,:
|,p,p,p,e,:,:,:,:,:,:,:
|,p,p,p,e,:,:,:,:,:,:,:
|,:,:,:,:,:,:,:,:,:,:,:
|,:,:,:,:,:,:,:,:,:,:,:
|,:,:,:,:,:,:,:,:,:,:,:
|,g,:,:,:,:,:,:,:,:,:,:
|,:,:,:,:,:,:,:,:,:,:,:
|,=,:,:,:,:,:,:,:,:,:,:
|,=,=,g,:,:,:,:,:,:,:,:
|,=,=,=,:,:,:,:,:,:,:,:
|,=,=,=,=,:,:,:,:,:,:,:
:,:,:,:,:,:,:,:,:,:,:,:
:,:,:,:,:,:,:,:,:,:,:,:
|,=,=,=,=,=,:,:,:,:,:,:
|,=,=,=,=,=,=,:,:,:,:,:
|,=,=,=,=,=,=,:,:,:,:,:
|,:,:,:,:,:,:,:,:,:,:,:
|,:,:,:,:,:,:,:,:,:,:,:
|,:,:,:,:,:,:,:,:,:,:,:
|,:,:,:,:,:,:,:,:,:,:,:
|,:,:,:,:,:,:,:,:,:,:,:
|,:,:,:,:,:,:,:,:,:,:,:
|,:,:,:,:,:,:,:,:,:,:,:
|,:,:,:,?,:,:,:,:,:,:,:
|,:,:,:,?,:,:,:,:,:,:,:
|,:,:,:,?,:,:,:,:,:,:,:
|,:,h,:,?,:,:,:,:,:,:,:
|,:,:,:,?,:,:,:,:,:,:,:
|,:,:,:,:,:,:,:,:,:,:,:
|,:,:,:,#,:,:,:,:,:,:,:
|,:,:,:,:,:,:,:,#,:,:,:
|,:,:,:,:,:,:,:,#,c,:,:
|,:,:,:,:,:,:,:,#,c,:,:
|,:,:,:,:,:,:,:,:,:,:,:
|,c,:,:,:,#,:,:,:,:,:,:
|,c,:,:,:,#,:,:,:,:,:,:
|,:,:,:,:,#,:,:,:,:,:,:
:,:,:,:,:,:,:,:,:,:,:,:
:,:,:,:,:,:,:,:,:,:,:,:
:,:,:,:,:,:,:,:,:,:,:,:
:,:,:,:,:,:,:,:,:,:,:,:
|,:,:,:,:,:,:,:,:,:,:,:
|,:,:,:,:,:,:,:,:,:,:,:
|,:,:,:,:,:,:,:,:,:,:,:
|,:,:,:,:,:,:,:,:,:,:,:
|,:,:,:,:,:,:,:,:,:,:,:
|,:,:,:,:,:,:,:,:,:,:,:
|,:,:,:,:,:,:,:,:,:,:,:
|,:,:,:,:,:,:,:,:,:,:,:
|,:,:,:,:,:,:,:,:,:,:,:
|,:,:,:,K,:,:,:,:,:,:,:
|,:,:,:,:,:,:,:,:,:,:,:
|,z,z,:,:,:,:,:,:,:,:,:
|,:,:,:,:,:,:,:,:,:,:,:
|,:,:,:,:,:,:,:,:,:,:,:
|,:,:,:,:,:,:,:,:,:,:,:
|,:,:,:,:,:,:,:,:,:,:,:
|,:,:,:,:,:,:,:,:,:,:,:
|,:,:,:,:,:,:,:,:,:,:,:
|,:,:,:,:,:,:,:,:,:,:,:
|,p,p,e,:,:,:,:,:,:,:,:
|,p,p,e,:,:,:,:,:,:,:,:
|,:,:,:,:,:,:,:,:,:,:,:
|,:,:,:,#,:,:,:,#,:,:,:
|,:,:,:,#,:,:,:,#,:,:,:
|,:,:,:,#,:,:,:,#,h,:,:
|,:,:,:,#,:,:,:,#,:,:,:
|,:,:,:,#,:,:,:,#,:,:,:
|,:,:,:,#,h,:,:,#,:,:,:
|,:,:,:,#,:,:,:,#,:,:,:
|,:,:,:,#,:,:,:,#,s,:,:
|,:,:,:,:,:,:,:,:,:,:,:
:,:,:,:,:,:,:,:,:,:,:,:
:,:,:,:,:,:,:,:,:,:,:,:
|,=,=,=,:,:,:,:,:,:,:,:
|,:,:,:,:,:,:,:,:,:,:,:
|,:,:,:,:,:,:,:,:,:,:,:
|,:,:,:,:,:,:,:,:,:,:,:
|,:,:,:,:,:,:,:,:,:,:,:
|,b,:,:,:,:,:,:,:,:,:,:
|,b,:,:,:,:,:,:,:,:,:,:
|,b,:,:,:,:,:,:,:,:,:,:
|,:,:,:,:,:,:,:,:,:,:,:
|,:,:,:,:,:,:,:,:,:,:,:
|,:,:,:,:,:,:,:,:,:,:,:
|,:,:,:,:,:,:,:,:,:,:,:
|,:,#,:,:,:,:,:,:,:,:,:
|,:,#,m,:,:,:,:,:,:,:,:
|,:,:,:,:,:,:,:,:,:,:,:
:,:,:,:,:,:,:,:,:,:,:,:
:,:,:,:,:,:,:,:,:,:,:,:
:,:,:,:,:,:,:,:,:,:,:,:
:,:,:,:,#,:,:,:,:,:,:,:
:,:,:,:,#,:,:,:,:,:,:,:
:,:,:,:,#,:,:,:,:,:,:,:
:,:,:,:,:,:,:,:,:,:,:,:
|,:,:,:,:,:,:,:,:,:,:,:
|,:,:,:,:,:,:,:,:,:,:,:
|,:,:,:,:,:,:,:,#,:,:,:
|,g,:,:,:,:,:,:,#,:,:,:
|,g,:,:,:,:,:,:,#,:,:,:
|,:,:,:,:,:,:,:,#,K,:,:
|,:,:,:,:,:,:,:,#,:,:,:
|,:,:,:,:,:,:,:,:,:,:,:
|,:,:,:,:,:,:,:,:,:,:,:
|,:,:,:,:,:,:,:,:,:,:,:
|,:,:,:,:,:,:,:,:,:,:,:
|,:,:,:,:,:,:,:,:,:,:,:
|,:,:,:,:,:,:,:,:,:,:,:
|,:,:,:,K,:,:,:,:,:,:,:
|,:,:,:,K,:,:,:,:,:,:,:
|,:,:,:,:,:,:,:,:,:,:,:
|,:,:,:,:,:,:,:,:,:,:,:
|,:,:,:,#,m,:,:,:,:,:,:
|,:,:,:,:,:,:,:,:,:,:,:
:,:,:,:,:,:,:,:,:,:,:,:
:,:,:,:,:,:,:,:,:,:,:,:
:,:,:,:,:,:,:,:,#,c,:,:
|,p,p,e,:,:,:,:,#,c,:,:
|,p,p,e,:,:,:,:,#,:,:,:
:,:,:,:,:,:,:,:,#,:,:,:
:,:,:,:,:,:,:,:,:,:,:,:
|,:,:,:,:,:,:,:,:,:,:,:
|,:,:,:,:,:,:,:,:,:,:,:
|,:,:,:,:,:,:,:,:,:,:,:
|,:,:,:,:,:,:,:,:,:,:,:
|,:,:,:,:,:,:,:,:,:,:,:
|,:,:,:,:,:,:,:,:,:,:,:
|,=,:,:,:,:,:,:,:,:,:,:
|,=,=,:,:,:,:,:,:,:,:,:
:,:,:,:,:,:,:,:,:,:,:,:
|,=,=,=,=,K,:,:,:,:,:,:
|,=,=,=,=,=,:,:,:,:,:,:
:,:,:,:,:,:,:,:,:,:,:,:
|,=,=,=,=,=,=,=,:,:,:,:
|,=,=,=,=,=,=,=,=,:,:,:
|,=,=,=,=,=,=,=,=,:,:,:
|,:,:,:,:,:,:,:,:,:,:,:
|,:,:,:,:,:,:,:,:,:,:,:
|,:,:,:,:,:,:,:,:,:,:,:
|,:,:,:,:,:,:,:,:,:,:,:
|,:,:,:,:,:,:,:,:,:,:,:
|,:,:,:,:,:,:,:,:,:,:,:
|,:,:,:,:,:,:,:,:,:,:,:
|,:,:,:,:,:,:,:,:,:,f,:
|,f,f,f,f,f,f,f,f,f,f,f
