|,:,:,:,:,:,:,:,:,:,:,:
|,:,:,:,:,:,:,:,:,:,:,:
|,:,:,:,:,:,:,:,:,:,:,:
|,:,:,:,:,:,:,:,:,:,:,:
|,:,:,:,:,:,:,:,:,:,:,:
|,:,:,:,:,:,:,:,:,:,:,:
|,:,:,:,:,:,:,:,:,:,:,:
|,:,:,:,:,:,:,:,:,:,:,:
|,:,:,:,:,:,:,:,:,:,:,:
|,:,:,:,:,:,:,:,:,:,:,:
|,:,:,:,:,:,:,:,:,:,:,:
|,:,:,:,:,:,:,:,:,:,:,:
|,:,:,:,:,:,:,:,:,:,:,:
|,:,:,:,:,:,:,:,:,:,:,:
|,:,:,:,:,:,:,:,:,:,:,:
|,:,:,:,:,:,:,:,:,:,:,:
|,:,:,:,:,:,:,:,:,:,:,:
|,:,:,:,:,:,:,:,:,:,:,:
|,z,z,:,:,:,:,:,:,:,:,:
|,:,:,:,:,:,:,:,:,:,:,:
|,:,:,:,:,:,:,:,:,:,:,:
|,:,:,:,:,:,:,:,:,:,:,:
|,:,:,:,:,:,:,:,:,:,:,:
|,:,:,:,:,:,:,:,:,:,:,:
|,:,:,:,:,:,:,:,:,:,:,:
|,:,:,:,:,:,:,:,:,:,:,:
|,:,:,:,:,:,:,:,:,:,:,:
|,:,k,:,:,:,:,:,:,:,:,:
|,:,:,:,:,:,:,:,:,:,:,:
|,:,:,:,:,:,:,:,:,:,:,:
|,:,:,:,:,:,:,:,:,:,:,:
|,:,:,:,:,:,:,:,:,:,:,:
|,:,:,:,:,:,:,:,:,:,:,:
|,:,:,:,:,:,:,:,:,:,:,:
|,Z,Z,Z,:,:,:,:,:,:,:,:
|,:,:,:,:,:,:,:,:,:,:,:
|,:,:,:,:,:,:,:,:,:,:,:
|,:,:,:,:,:,:,:,:,:,:,:
|,:,:,:,:,:,:,:,:,:,:,:
|,:,:,:,:,:,:,:,:,:,:,:
|,:,:,:,:,:,:,:,:,:,:,:
|,:,:,:,:,:,:,:,:,:,:,:
|,:,:,:,:,:,:,:,:,:,:,:
|,:,:,:,:,:,:,:,:,:,:,:
|,:,:,:,:,:,:,:,:,:,:,:
|,:,:,:,:,:,:,:,:,:,:,:
|,:,:,:,:,:,:,:,:,:,:,:
|,:,:,:,:,:,:,:,:,:,:,:
|,:,:,:,:,:,:,:,:,:,:,:
|,:,:,:,:,:,:,:,:,:,:,:
|,:,:,:,:,:,:,:,:,:,:,:
|,:,:,:,:,:,:,:,:,:,:,:
|,:,:,:,:,:,:,:,:,:,:,:
|,p,p,p,p,e,:,:,:,:,:,:
|,p,p,p,p,e,:,:,:,:,:,:
|,:,:,:,:,:,:,:,:,:,:,:
|,:,:,:,:,:,:,:,:,:,:,:
|,:,:,:,:,:,:,:,:,:,:,:
|,:,:,:,:,:,:,:,:,:,:,:
|,:,:,:,:,:,:,:,:,:,:,:
|,:,:,:,#,:,:,:,#,:,:,:
|,:,:,:,#,:,:,:,#,:,:,:
|,:,:,:,#,:,:,:,#,:,:,:
|,:,:,:,#,:,:,:,#,:,:,:
|,:,:,:,#,h,:,:,#,:,:,:
|,:,:,:,#,:,:,:,#,:,:,:
|,h,:,:,#,:,:,:,#,m,:,:
|,:,:,:,#,:,:,:,#,:,:,:
|,:,:,:,:,:,:,:,:,:,:,:
:,:,:,:,:,:,:,:,:,:,:,:
:,:,:,:,:,:,:,:,:,:,:,:
|,=,=,=,=,:,:,:,:,:,:,:
|,=,=,=,:,:,:,:,:,:,:,:
|,=,=,:,:,:,:,:,:,:,:,:
|,=,:,:,:,:,:,:,:,:,:,:
:,:,:,:,:,:,:,:,:,:,:,:
:,:,:,:,:,:,:,:,:,:,:,:
|,:,:,:,:,:,:,:,:,:,:,:
|,:,:,:,:,:,:,:,:,:,:,:
|,:,:,:,:,:,:,:,:,:,:,:
|,:,:,:,:,:,:,:,:,:,:,:
|,:,:,:,:,:,:,:,:,:,:,:
|,:,:,:,:,:,:,:,:,:,:,:
|,:,:,:,:,:,:,:,:,:,:,:
|,:,:,:,:,:,:,:,:,:,:,:
|,:,:,:,:,:,:,:,:,:,:,:
|,z,z,:,:,:,:,:,:,:,:,:
|,:,:,:,:,:,:,:,:,:,:,:
|,:,:,:,:,:,:,:,:,:,:,:
|,:,:,:,:,:,:,:,:,:,:,:
|,:,:,:,:,:,:,:,:,:,:,:
|,:,K,:,:,:,:,:,:,:,:,:
|,:,:,:,:,:,:,:,:,:,:,:
|,:,:,:,:,:,:,:,:,:,:,:
|,:,:,:,:,:,:,:,:,:,:,:
|,=,=,=,:,:,:,:,:,:,:,:
|,:,:,:,:,:,:,:,:,:,:,:
|,:,:,:,:,:,:,:,:,:,:,:
|,:,:,:,:,:,:,:,:,:,:,:
|,:,:,:,:,:,:,:,:,:,:,:
|,:,:,:,:,:,:,:,:,:,:,:
|,:,:,:,:,:,:,:,:,:,:,:
|,:,:,:,:,:,:,:,:,:,:,:
|,:,:,:,:,:,:,:,:,:,:,:
|,:,:,:,:,:,:,:,:,:,:,:
|,:,:,:,:,:,:,:,:,:,:,:
|,:,:,:,:,:,:,:,:,:,:,:
|,:,:,:,:,:,:,:,:,:,:,:
|,:,:,:,:,:,:,:,:,:,:,:
|,=,=,=,=,:,:,:,:,:,:,:
|,=,=,=,=,:,:,:,:,:,:,:
|,:,:,:,:,:,:,:,:,:,:,:
|,:,:,:,:,:,:,:,:,:,:,:
|,:,:,:,:,:,:,:,:,:,:,:
|,:,:,:,:,:,:,:,:,:,:,:
|,:,:,:,#,:,:,:,#,:,:,:
|,:,:,:,#,:,:,:,#,m,:,:
|,:,:,:,#,:,:,:,#,:,:,:
|,h,:,:,#,:,:,:,#,:,:,:
|,:,:,:,#,:,:,:,#,:,:,:
|,:,:,:,#,h,:,:,#,:,:,:
|,:,:,:,#,:,:,:,#,:,:,:
|,:,:,:,#,:,:,:,#,:,:,:
|,:,:,:,:,:,:,:,:,:,:,:
:,:,:,:,:,:,:,:,:,:,:,:
:,:,:,:,:,:,:,:,:,:,:,:
|,p,p,p,p,e,:,:,:,:,:,:
|,p,p,p,p,e,:,:,:,:,:,:
:,:,:,:,:,:,:,:,:,:,:,:
:,:,:,:,:,:,:,:,:,:,:,:
|,:,:,:,:,:,:,:,:,:,:,:
|,:,:,:,:,:,:,:,:,:,:,:
|,:,:,:,:,:,:,:,:,:,:,:
|,:,:,:,:,:,:,:,:,:,:,:
|,:,:,:,:,:,:,:,:,:,:,:
|,:,:,:,:,:,:,:,:,:,:,:
|,k,:,:,:,:,:,:,:,:,:,:
|,:,:,:,:,:,:,:,:,:,:,:
|,:,:,:,:,:,:,:,:,:,:,:
|,:,:,:,:,:,:,:,:,:,:,:
|,:,:,:,:,:,:,:,:,:,:,:
|,:,:,:,:,:,:,:,:,:,:,:
|,:,:,:,:,:,:,:,:,:,:,:
|,:,:,:,:,:,:,:,:,:,:,:
|,:,:,:,:,:,:,:,:,:,:,:
|,:,:,:,:,:,:,:,:,:,:,:
|,h,:,:,:,:,:,:,:,:,:,:
|,:,:,:,:,:,:,:,:,:,:,:
|,:,:,:,:,:,:,:,:,:,:,:
|,:,:,:,:,:,:,:,:,:,:,:
|,:,:,:,:,:,:,:,:,:,:,:
|,:,:,:,:,:,:,:,:,:,:,:
|,:,:,:,:,:,:,:,:,:,:,:
|,:,:,:,:,:,:,:,:,:,:,:
|,:,:,:,:,:,:,:,:,:,:,:
|,:,:,:,:,:,:,:,:,:,:,:
|,:,:,:,:,:,:,:,:,:,:,:
|,:,:,:,:,:,:,:,:,:,:,:
|,:,:,:,:,:,:,:,:,:,:,:
|,:,:,:,:,:,:,:,:,:,:,:
|,:,:,h,:,:,:,:,:,:,:,:
|,:,:,:,:,:,:,:,:,:,:,:
|,:,:,:,:,:,:,:,:,:,:,:
|,:,:,:,:,:,:,:,:,:,:,:
|,:,:,:,:,:,:,:,:,:,:,:
|,:,:,:,:,:,:,:,:,:,:,:
|,:,:,:,:,:,:,:,:,:,:,:
|,:,:,:,:,:,:,:,:,:,:,:
|,p,p,p,e,:,:,:,:,:,:,:
|,p,p,p,e,:,:,:,:,:,:,:
|,:,:,:,:,:,:,:,:,:,:,:
|,:,:,:,:,:,:,:,:,:,:,:
|,:,:,:,:,:,:,:,:,:,:,:
|,:,:,:,:,:,:,:,:,:,:,:
|,:,:,:,:,:,:,:,:,:,:,:
|,:,:,:,:,:,:,:,:,:,:,:
|,:,:,:,:,:,:,:,:,:,:,:
|,k,:,:,:,:,:,:,:,:,:,:
|,:,:,:,:,:,:,:,:,:,:,:
|,:,:,:,:,:,:,:,:,:,:,:
|,:,:,:,:,:,:,:,:,:,:,:
|,:,:,:,:,:,:,:,:,:,:,:
|,:,:,:,:,:,:,:,:,:,:,:
|,:,:,:,:,:,:,:,:,:,:,:
|,:,:,:,:,:,:,:,:,:,:,:
|,:,:,:,:,:,:,:,:,:,:,:
|,h,:,:,:,:,:,:,:,:,:,:
|,:,:,:,:,:,:,:,:,:,:,:
|,:,:,:,:,:,:,:,:,:,:,:
|,:,:,:,:,:,:,:,:,:,:,:
|,:,:,:,#,:,:,:,:,:,:,:
|,:,:,:,:,:,:,:,:,:,:,:
|,:,:,:,:,:,:,:,:,:,:,:
|,:,:,:,:,:,:,:,:,:,:,:
|,:,:,:,:,:,:,:,:,:,:,:
|,=,=,:,:,:,:,:,:,:,:,:
|,:,:,:,:,:,:,:,:,:,:,:
:,:,:,:,:,:,:,:,:,:,:,:
:,:,=,:,:,:,:,:,:,:,:,:
:,:,:,:,:,:,:,:,:,:,:,:
:,:,:,:,=,:,:,:,:,:,:,:
:,:,:,:,:,:,:,:,:,:,:,:
:,:,:,:,:,:,=,:,:,:,:,:
:,:,:,:,:,:,:,:,:,:,:,:
:,:,:,:,:,:,:,:,=,:,:,:
:,:,:,:,:,:,:,:,=,:,:,:
:,:,:,:,:,:,:,:,:,:,:,:
:,:,:,:,:,:,:,:,:,:,:,:
|,:,:,:,:,:,:,:,:,:,:,:
|,:,:,:,:,:,:,:,:,:,:,:
|,:,:,:,:,:,:,:,:,:,:,:
|,:,:,:,:,:,:,:,:,:,:,:
|,:,:,:,:,:,:,:,:,:,:,:
|,:,:,:,:,:,:,:,:,:,f,:
|,f,f,f,f,f,f,f,f,f,f,f
