0000000000000000000000000000000000000000000000000000000000000000000000000000000000000000000000000000000000000000000000000000000000000000000000000000000000000000000000000000000000000000000000000000000000000000000
0000000000000000000123000000000000001223000000000000000000000000000123000000000000001223000000000000000000000000000123000000000000001223000000000000000000000000000123000000000000001223000000000000004000000000000
0000000012300000000567000001222300005667000000000000000012300000000567000001222300005667000000000000000012300000000567000001222300005667000000000000000012300000000567000001222300005667000000000000089012300000000
000000005670000000000000000566670000000000000000000000005670000000000000000566670:;00000000000000000000056700<0000000000000566670000000000000000000000005670000000000000000566670000000000000000000000=056700000000
0000000000000000000000>000000000000000000000000000000000000000000000000000000000?@A?????000???>00000000000000>00000000000???0000?>>?00000000000000000000000000000000000000000000000000000000BB00000000C000000000000
000000000000000000000000000000000000000000000000000000000000000000000000000000DE00000000000000000000000000000000000000000000000000000000000000000000000000000000000000000000000000000000000BBB00000000C000000000000
0000000000000000000000000000000000000000000000000000000000000000F0000000000000GH00000000000000I0000000000000000000000000000000000000000000000000000000000000000000000000000000000000000000BBBB00000000C00000J000000
000000000000000000000<000000000000000000000000000000000000000000K0000000000000<000000000000000L000000M00000000000000000000000000000000000000000000000000000000000000000000000000000000000BBBBB00000000C0000NNN00000
0000000000000000>000?>?>?000000000000000000000OP000000000OP000000000000000000?>?00000000000000?00000?K0000>00>00>00000?0000000000??000000B00B0000000000BB00B000000000000??>?000000000000BBBBBB00000000C0000QRS00000
00T00000000000000000000000000000000000OP000000UV00T000000WX000000000000000000000000000000000000000T0000000000000000000000000000000000000BB00BB0000T000BBB00BB00000000000000000000000000BBBBBBB0000T000C000NYYYN0000
0Z[\0000000000000T0000000000OP00000000UV000000UV0Z[\00000]^000000T0000000000000000000000000000000Z[\00000_`000000T000000000000000000000BBB00BBB00Z[\0BBBB00BBB000T0OP00000000000000OP0BBBBBBBB000Z[\00C000RRaRR00T0
Z[bc\000000deeefZ[\0gh0def00UV00000000UVijeef0UVZ[[[khlm0UVdeeefZ[\0000def000000000000000deef0nopq[[\0000rsdeeefZ[\0000def0tuonoiv0000BBBBeeBBBBZ[[[BBBBB00BBBBfZ[\wx00def000yz{000UVBBBBBBBBB00Z[[[\0B000RR[RRfZ[\
||}~||||||||||||||||Ä||||||||||||||||||ÅÇ||||||||||ÄÉ||||||||||||||00|||||||||||||||000||||||ÑÖÜ||||||||á||||||||||||||||àâÑ|ÑÅÇ|||||||||||||||||||||||00||||||||||||||||||äãå|||||||||||||||||||||||||||||||||||
