-------------------------------------------------------------------------------------------------------------------------------------------------------------------------------------------------------
------------------------------------------------------------------------------------------------------------------------------------------------------------------------------------------------------1
-----------------------------------------------------------------------------------------------------------------------------------------------------------------------------------------------------23
---------------------------------------------------------------------------------45--------------------------6----------------------------------------------------------------------------------------7
----------------------8---------------------------------------------------------9:;99999---9998--------------8-----------999----9889--------------------------------------------------------<<--------=
------------------------------------------------------------------------------>?-----------------------------------------------------------------------------------------------------------<<<--------=
----------------------------------------------------------------@-------------AB--------------C-------------------------------------------------------------------------------------------<<<<--------=
---------------------6------------------------------------------D-------------6---------------E------F-----------------------------------------------------------------------------------<<<<<--------=
----------------8---98989---------------------GH---------GH------------------989--------------9-----9D----8--8--8-----9----------99------<--<----------<<--<------------9989------------<<<<<<--------=
--------------------------------------GH------IJ---------IJ-----------------------------------------------------------------------------<<--<<--------<<<--<<--------------------------<<<<<<<--------=
----------------------------GH--------IJ------IJ---------IJ----------------------------------------------KL----------------------------<<<--<<<------<<<<--<<<-----GH--------------GH-<<<<<<<<--------=
--------------------MN------IJ--------IJOP----IJ----QNRS-IJ-----------------------------------TUVW-------XY----------------Z[UTUOP----<<<<--<<<<----<<<<<--<<<<----IJ--------\]^---IJ<<<<<<<<<--------<
____________________`a__________________bc___________________________--_______________---______def________g_________________h____________________________--___________________hh_______________________
