100000000000
100000000000
100000000000
100000000000
100000000000
100000000000
100000000000
100000000000
100000000000
100000000000
100000000000
100000000000
100000000000
100000000000
100000000000
100000000000
100020000000
100000000000
100000000000
100000000000
540030000000
870026000000
100030002000
100020000000
100030000000
100000000000
100000000000
100000000000
1:9000000000
1<;000000000
100000000000
100000000000
100000000000
100000000000
100000000000
100000000000
100000000000
100000000000
1::900000000
1<<;00000000
>=0000000000
@?0000000000
100000000000
100000000000
100000000000
100000000000
1:::90000000
1<<<;0000000
100000000000
100000000000
100000000000
100000000000
1A0000000000
170000000000
1B0000000000
1C0000000000
100000000000
1:::90000000
1<<<;0000000
100000000000
100000000000
100000000000
100000000000
100000000000
10000ED00000
100000000000
100000000000
100000000000
100000000000
000000000000
000000000000
100000000000
100000000000
100000000000
100000000000
100000000000
100000000000
100030000000
100026GF0000
100030IH0000
100000003000
10000000KJ00
10000000ML00
100000003000
100000003000
100000003000
000000003000
000000003000
000000000000
100000000000
100000000000
100000003000
100000003000
100000003000
1P003ON02000
RQ0000000000
TS0000000000
VU0000000000
100000000000
100000000000
100030000000
1000EW000000
100000000000
100000000000
100000000000
1YX000000000
\[Z020000000
100000000000
100000000000
100020002600
100000000000
100000000000
100020000000
100000000000
100000000000
100000000000
100000000000
100000000000
100030000000
100000000000
100000000000
100000003000
100000003000
1]0000003000
_^0000000000
1Q0000000000
1P0000000000
1Q0000000000
1=0000003000
1?0030002000
100030002000
100000003000
100000000000
100000000000
1`0000000000
1``000000000
1```00000000
1````0000000
100000000000
100000000000
1````0000000
1```00000000
1``000000000
1`0000000000
100000000000
100000000000
100000000000
100000000000
1`0000000000
1``000000000
1```00000000
1````0000000
1````0000000
000000000000
000000000000
1````0000000
1```00000000
1``000000000
1`0000000000
100000000000
100000000000
100000000000
100000000000
1:9000000000
1<;000000000
100000000000
100000000000
100000000000
100030000000
100030000000
100020000000
100030000000
100000000000
1a0000000000
_b0000000000
_c0000000000
100000000000
100000000000
100000000000
1:9000000000
1<;000000000
1`0000000000
1``000000000
1```00000000
1````0000000
1`````000000
1``````00000
1```````0000
1````````000
1````````000
100000000000
100000000000
100000000000
100000000000
100000000000
100000000000
100000000000
1000000000d0
1`hhhhhhhgfe
