0122222222222
0122222222222
0122222222222
0122222222222
0122222222222
0122222222222
0122222222222
0122222222222
0122222222222
0122222222222
0122222222222
0122222222222
0122222222222
0122222222222
0122222222222
0122222222222
0122342222222
0122222222222
0122222222222
0122222222222
0562782222222
09:23;<222222
0122782234222
0122342222222
0122782222222
0122222222222
0122222222222
0122222222222
0=>?222222222
0@AB222222222
0122222222222
0122222222222
0122222222222
0122222222222
0122222222222
0122222222222
0122222222222
0122222222222
0=C>?22222222
0@DAB22222222
0EF2222222222
0GH2222222222
0122222222222
0122222222222
0122222222222
0122222222222
0=CC>?2222222
0@DDAB2222222
0122222222222
0122222222222
0122222222222
0122222222222
0I62222222222
0J:2222222222
0KL2222222222
0M22222222222
0122222222222
0=CC>?2222222
0@DDAB2222222
0122222222222
0122222222222
0122222222222
0122222222222
0122222222222
01222NOP22222
0122222222222
0122222222222
0122222222222
0122222222222
2222222222222
2222222222222
0122222222222
0122222222222
0122222222222
0122222222222
0122222222222
0122222222222
0122782222222
01223;<Q22222
012278RS22222
0122222278222
012222227TU22
012222227VW22
0122222278222
0122222278222
0122222278222
2222222278222
2222222278222
2222222222222
0122222222222
0122222222222
0122222278222
0122222278222
0122222278222
0XY27Z[\34222
0]^2222222222
0_`2222222222
0ab2222222222
0122222222222
0122222222222
0122782222222
0122Ncd222222
0122222222222
0122222222222
0122222222222
0ef2222222222
0gh2342222222
0122222222222
0122222222222
012234223;<22
0122222222222
0122222222222
0122342222222
0122222222222
0122222222222
0122222222222
0122222222222
0122222222222
0122782222222
0122222222222
0122222222222
0122222278222
0122222278222
0ij2222278222
0kl2222222222
0m^2222222222
0XY2222222222
0m^2222222222
0nF2222278222
0oH2782234222
0122782234222
0122222278222
0122222222222
0122222222222
0pq2222222222
0prq222222222
0prrq22222222
0prrrq2222222
0122222222222
0122222222222
0prrrq2222222
0prrq22222222
0prq222222222
0pq2222222222
0122222222222
0122222222222
0122222222222
0122222222222
0pq2222222222
0prq222222222
0prrq22222222
0prrrq2222222
0prrrq2222222
2222222222222
2222222222222
0prrrq2222222
0prrq22222222
0prq222222222
0pq2222222222
0122222222222
0122222222222
0122222222222
0122222222222
0=>?222222222
0@AB222222222
0122222222222
0122222222222
0122222222222
0122782222222
0122782222222
0122342222222
0122782222222
0122222222222
0st2222222222
0uv2222222222
0wx2222222222
0122222222222
0122222222222
0122222222222
0=>?222222222
0@AB222222222
0pq2222222222
0prq222222222
0prrq22222222
0prrrq2222222
0prrrrq222222
0prrrrrq22222
0prrrrrrq2222
0prrrrrrrq222
0prrrrrrrq222
0122222222222
0122222222222
0122222222222
0122222222222
0122222222222
0122222222222
0122222222222
01222222222y2
0pz{{{{{{{|}2
