0000000000000000000000000000000000000000000000000000000000000000000000000000000000000000000000000000000000000000000000000000000000000000000000000000000000000000000000000000000000000000000000000000000000000000000
0000000000000000000000000000000000000000000000000000000000000000000000000000000000000000000000000000000000000000000000000000000000000000000000000000000000000000000000000000000000000000000000000000001000000000000
0000000000000000000000000000000000000000000000000000000000000000000000000000000000000000000000000000000000000000000000000000000000000000000000000000000000000000000000000000000000000000000000000000023000000000000
0000000000000000000000000000000000000000000000000000000000000000000000000000000004500000000000000000000000000600000000000000000000000000000000000000000000000000000000000000000000000000000000000000007000000000000
000000000000000000000080000000000000000000000000000000000000000000000000000000009:;999990009998000000000000008000000000009990000988900000000000000000000000000000000000000000000000000000000<<00000000=000000000000
000000000000000000000000000000000000000000000000000000000000000000000000000000>?00000000000000000000000000000000000000000000000000000000000000000000000000000000000000000000000000000000000<<<00000000=000000000000
0000000000000000000000000000000000000000000000000000000000000000@0000000000000AB00000000000000C0000000000000000000000000000000000000000000000000000000000000000000000000000000000000000000<<<<00000000=00000D000000
0000000000000000000006000000000000000000000000000000000000000000E00000000000006000000000000000F000000G00000000000000000000000000000000000000000000000000000000000000000000000000000000000<<<<<00000000=0000HHH00000
0000000000000000800098989000000000000000000000IJ000000000IJ000000000000000000989000000000000009000009E00008008008000009000000000099000000<00<0000000000<<00<0000000000009989000000000000<<<<<<00000000=0000KLM00000
00000000000000000000000000000000000000IJ000000NO000000000NO00000000000000000000000000000000000000000000000000000000000000000000000000000<<00<<00000000<<<00<<00000000000000000000000000<<<<<<<00000000=000HPPPH0000
0000000000000000000000000000IJ00000000NO000000NO000000000NO0000000000000000000000000000000000000000000000QR0000000000000000000000000000<<<00<<<000000<<<<00<<<00000IJ00000000000000IJ0<<<<<<<<00000000=000LLSLL0000
00000000000000000000TU000000NO00000000NOVW0000NO0000XUYZ0NO00000000000000000000000000000000000[\]^0000000_`0000000000000000ab\[\VW0000<<<<00<<<<0000<<<<<00<<<<0000NO00000000cde000NO<<<<<<<<<00000000<000LLfLL0000
gggggggggggggggggggghiggggggggggggggggggjkggggggggggggggggggggggggggg00ggggggggggggggg000gggggglmnggggggggogggggggggggggggggpgggggggggggggggggggggggggggg00gggggggggggggggggggppggggggggggggggggggggggggggggggggggg
