-----------------------------------------
-----------------------------------------
-----------------------------------------
-----------------------------------------
-----------------------------------------
-----------------------------------------
-----------------------------------------
---------------------M-------------------
----------------?---=?=?=----------------
--------------------------------------pp-
----------------------------pp--------pp-
--C------------------G------pp--------ppG
_________________________________________