-----------------------------------------------------------------------------------------1-------------------------------------------------------------------------------
2-----222222222222222222222222222222222222222222222222222222222222222222222222222222222223222222222222222222222222222222222222222222222222-----------------------22222224
2-----------------------------------------------------22--222222--2222------2222----------------------------------------------------------------------------------------4
2-----------------------------------------------------22--222222--2222-56---2222-----------------------------------------------------------7889-----------:;;<----------4
2----------------------------------------====-------22--------22---2---->2----------======----------------------------------------------------------------?@@A----------4
2----------------------------B----------------C-----22--------22---2----2D----------------------------------------------------------------------------------------------4
2----------------------------E---------2-2222-3-----22--------22---2-F--2G----------222222-------------------HI---------------------------------------F-----------------4
2---------F------------------3---------2=2--2=2-----22----====22---2=3--23--JK------222222-------------HI----LM----------------------------------222223---------------NOP
2---------QQQQQ--------R-R-------------222--222-----2222--222222---222--22-STU22-----------------------LM----VW----HI-----------------XYRZ----------------------------[\]
2--------------------R-R-R-R---R----------------------22-------------------^---------------------------VW----4_----LM-----22----------`abZ-cdde-----------------222222222
2------------------R-R-R-R-R---R-R-------fgh--------i-22-----------------------------------------------4_----4_----VW-----22--------jkRbbZ---------lm-----------222222222
2------------nop-R-R-R-R-R-Rqr-R-R-------stu--------vw-----xy-JK-------------------------------z{|}~---4_----4_-Ä-4_-----22--------ÅÇbbbZ---------ÉÑ-----:;;<--222222222
ÖÖÖÖÖÖÖÖÖÖÖÖÖÜáàÖÖÖÖÖÖÖÖÖÖÖÖâäÖÖÖÖÖÖÖÖÖÖÖãåçÖÖÖÖÖÖÖÖéèÖÖÖÖÖêëÖíìÖÖÖÖÖÖÖÖÖÖÖÖÖÖÖî---ïÖÖÖÖÖÖÖÖÖÖÖÖñóàòÖÖÖôôÖÖÖÖôôÖöõÖôôÖÖî--ïî--ïÖÖÖÖÖÖÖôôôú-------ïÖùÖÖÖÖî-?@@A--ïÖÖÖÖÖÖÖÖ
