00000000000000000000000000000000000000000000000000000000000000000000000000000000000000000100000000000000000000000000000000000000000000000000000000000000000000000000000000000000000000000000000
00000000000000000000000000000000000000000000000000000000000000000000000000000000000000000000000000000000000000000000000000000000000000000000000000000000000000000000000023000000000000000000000
04500000000000000000000000000000000000000000000000000000000000000000000000000000000000000000000000000000000000000000000000000000000000000000000000000000000000000000000023000000000000000000000
06700000000000000000000000000000000000000000000000000000000000000000000080000000000000000000000000000000000000000000000000000000000000000009::;00000000000<==>000000000023000000000000000000000
00000000000000000000000000000000000000000????000000000000000000000000000@00000000000??????0000000000000000000000000000000000000000000000000000000000000000ABBC000000000023000000000000000000000
00000000000000000000000000000D0000000000000000E00000000000000000000000000D00000000000000000000000000000000000000000000000000000000000000000000000000000000000000000000002300000000FGHIJKLMNOP00
00000000000000000000000000000Q000000000000000000000000000000000000000R000Q00000000000000000000000000000000000ST000000000000000000000000000000000000000R0000000000000000023000000000000000000000
0000000000R00000000000000000000000000000?0000?000000000000????000000?0000000UV0000000000000000000000000ST0000WX0000000000000000000000000000000000000000000000000000000YZ[300000000\000]000^0000
0000000000_____00000000`0`0000000000000000000000000000000000000000000000000abc0000000000000000000000000WX0000de0000ST00000000000000000f0``0000000000000000000000000000ghi3000000000000000000000
000000000000000000000`0`0`0`000`0000000000000000000000000000000000000000000j000000000000000000000000000de0000230000WX00000000000000000kl``0mnno00000000000000000000000000000000000de00de00de000
0000000000000000000`0`0`0`0`000`0`0000000pqr00000000s00000000000000000000000000000000000000000000000000tu0000230000de000000000000000vw````000000000xy000000000000000000000000000002300230023000
0000000000000z{|0`0`0`0`0`0`}~0`0`0000000€00000000‚ƒ00000„…0UV00000000000000000000000000000000†‡ˆ‰000Š‹0000230Œ0Ž000000000000000‘````000000000’“00000<==>000000000000000000002300230023000
”””””””””””””•–—””””””””””””˜™”””””””””””š›œ””””””””ž”””””Ÿ ”¡¢””””””””””””””””000”””””””””””””£¤—¥””””””””””””¦§””””””00””00””””””””””””0000000””¨”””””0ABBC00”””””””””””””””””””””””””””””””
