00000000000000000000000000000000000000000000000000000000000000000000000000000000000000000000000000000000000000000000000000000000000000000000000000000000000000000000
00000000000000000012230000000000000004400000000000000000000000000012230000000000000000000000000000000000000000000012230000000000000000000000000000000000500000666012
0001223000000000007889000:;00000000000000<00<0000001223000000000007889000000000000000000000000000001223000000000007889000000000000000000000000000001223=>00000?@A078
0007889000000000000000000BC4440000000000DEEEEEF000078890000044440000000000G000000000000000000440044788900000000000H0000000000000000000000000000000078890I00006JJJ600
0000000000000000000000000KLEEEF0000000000MMMMM00000000000000DEEF0000000000N00O000000044000000000000000000PQ0000000R000004400000000000000000000SS00000000T0000@@U@@00
000000000000000000000000000MMM00000000123MMMMM000044000000000MM0000000000000DEEEEF00001230000000000000000VW00000000000000000000XYYZ00012300000SS00000000T0000@@[@@00
000000000123000000000000000MMM00000123789MMMMM000000000001230MM00000000000000MMMM00123789000000000000000D\]EEEEF0000000000000000000123789000SSSS00000000T1266JJJJJ66
066600000789000000000000000MMM00000DEEEF0MMMMM000000000007890MM00000000000000MMMM00789^^^0000000000000000MMMMMM00000000000000000000789000000SSSS00000000T78@@@U@U@@@
0?@A00000000000000000000DEEEEEEF0000MMM00MMMMM0000000000000_0MM0000000DEF0000MMMM0000000000000^^^00000000MMMMMM00000DEEF00DEEF000000000000SSSSSS00000000T00@@@[@[@@@
6JJJ600000000000000000000MMMMMM00000MMM00MMMMM000000000```0a0MM00000000M00000MMMM000000000000000000000000MMMMMM000000MM0000MM0000000000000SSSSSS00000000T00@@@@@@@@@
@@U@@00000000000000000000MMMMMM00400MMM00MMMMM123000000000000MM00000000M00001MMMM00000000000001230DEEF000MMMMMM000000MM0000MM230000000b000SSSSSS30000000T00@@U@U@U@@
@@cd@0000000000000DEEF000MMMMMM0DEF0MMM00MMMMM789000000000000MM00000000M00007MMMM000000000000078900MM0000MMMMMM004440MM0000MM89000000ef000SSSSSS90000000S00@@[@[@[@@
gghigggggggggggg000MM0000MMMMMM00M00MMM00MMMMM0000DEEF00000DEEEF0DEEEF0M00000MMMM000000000000000000MM0000MMMMMM00DEF0MM0000MM0000gggggjggggggggggggggggggggggggggggg
