322100000000
322541000000
376521000000
322581000000
322100000000
300000000000
300000000000
300000000000
300000000000
300000000000
300000000000
300000000000
300000000000
300000000000
300000000000
300000000000
000000000000
000000000000
090000000000
;:0000000000
;:0000000000
0<0000000000
000000000000
000000000000
000090000000
;;;;:000?>=0
;;;;:000BA@0
;;;;:;;;:C00
;;;;:;;;:C00
;;;;:;;;:C00
;;;;:000<000
0000<0000000
090000000000
;:C000000000
0<0000000000
000009000000
;;;;;:000000
;;;;;:00000C
;;;;;:00000C
00000<000000
000000000900
;;;;;;;;;:D0
;;;;;;;;;:00
;;;;;;;;;:00
;;;;;;;;;:D0
;;;;;;;;;:00
000000000<00
000000000000
000000000000
000000000000
9000000C0000
:000000C0000
:00000000000
<00000000000
000000000000
000E00000000
000E00000000
000E00000000
000000000000
900GF0000000
:00000009C00
:;;;;;;;:C00
:;;;;;;;:C00
<0000000<C00
000000000000
900000000000
:00000000000
:00000000000
:00000000000
<00000000000
000090000000
;;;;:0000000
0000<0000000
000000000000
00000000IH00
000000000000
000000090000
;;;;;;;:J000
;;;;;;;:0000
;;;;;;;:0000
;;;;;;;:0000
0000000<0000
000000000000
000000000000
000000000000
00000000C000
00000K00C000
00000K000000
00000K000000
000000000000
000000000000
000000000000
000000000000
000000000C00
0000K0000C00
0000K0000000
0000K0000000
000000000C00
009000000C00
;;:000000000
;;:000000000
00<000000000
000000000000
000000000000
000000900000
;;;;;;NML000
;;;;;;QPO000
;;;;;;:00000
;;;;;;:00000
;;;;;;:00000
;;;;;;:00000
000000<00000
000000000000
9C0000000000
:C000000SR00
<C0000000000
000090000000
;;;;:0000000
;;;;:0000000
0000<0000000
00000000C000
00000000C000
000090000000
;;;;:0000000
;;;;:0000000
0000<0000000
000000000000
0000000T0000
0000000U0000
3000000U0000
3000000V0000
300000000000
300000000000
3W0000000000
ZYX000000000
300000000000
300000000000
300000000000
3[[[[0000000
3[[[[0000000
3[[[[[[00000
3[[[[[[00000
3[[[[[[[[000
3[[[[[[[[000
3]\000000000
300000000000
300000000000
300000000000
300000000000
300000000000
300000000000
3000000000^0
3[bbbbbbba`_
