---------------------------------------------------------------------------------------------------------------------------------------------------------
-------------------------------------11-----------------------------------------------------------------------------------------------------------------2
-------------------------34--------------5--5----------------------------------------------------------------------------------------------------------67
-------------------------89111----------:;;;;;<-------------1111----------=------------------11--11--------------->-------------------------------------?
-------------------------@A;;;<----------BBBBB--------------:;;<----------C--D-------11------------------EF-------G-----11--------------------HH--------I
---------------------------BBB-----------BBBBB----11---------BB-------------:;;;;<-----------------------JK--------------------LMMN-----------HH--------I
---------------------------BBB-----------BBBBB---------------BB--------------BBBB-----------------------:OP;;;;<----------------------------HHHH--------I
-QQQ-----------------------BBB-----:;;;<-BBBBB---------------BB--------------BBBB-----RRR----------------BBBBBB-----------------------------HHHH--------I
-STU--------------------:;;;;;;<----BBB--BBBBB-------------V-BB-------:;<----BBBB-------------RRR--------BBBBBB-----:;;<--:;;<------------HHHHHH--------I
QWWWQ--------------------BBBBBB-----BBB--BBBBB---------XXX-Y-BB--------B-----BBBB------------------------BBBBBB------BB----BB-------------HHHHHH--------I
TTZTT--------------------BBBBBB--1--BBB--BBBBB---------------BB--------B-----BBBB-----------------:;;<---BBBBBB------BB----BB---------[---HHHHHH\-------I
TT]TT-------------:;;<---BBBBBB-:;<-BBB--BBBBB---------------BB--------B-----BBBB------------------BB----BBBBBB--111-BB----BB--------^_---HHHHHH`-------H
aaaaaaaaaaaaaaaa---BB----BBBBBB--B--BBB--BBBBB----:;;<-----:;;;<-:;;;<-B-----BBBB------------------BB----BBBBBB--:;<-BB----BB----aaaaabaaaaaaaaaaaaaaaaaa
