000000000000000000000000000000000000000000000000000000000000000000000000000000000001200000000000000000000000000000000000000000000000000000000000000000000000000000300000000000000000000000000000000000000000000000000
044400000000000000000000000567000000000000000567000000000000000000000000000567000001000000000567000000000000000000000000000567000000000000000567000000000000000000000000000567000000000000000567000000008000000000000
09:;00000000000000567000000<=>566700000000000<=>566700000000000000567000000<=>566701000000000<=>566700000000000000567000000<=>566700000000000<=>566700000000000000567000000<=>566700000000000<??5667000@A000000000567
4BBB40000000000000<=>0000000C0<==>00000000000000<==>00000000000000<=>D00000000<==>01000000000000<==>00000000000000<=>00000000E<==>00000000000000<==>00000000000000<=>0000000E0<==>000000000000??<==>0000F000000000<=>
::G::00000000000000000000000HIII000000000000000000000JJJJJ00000000000HIII00000000IIHII000000IIII00000000000000000000000000000HIII00000000000000000000000000000000000IIIII000H0000000000000H000??00000000K000000000000
::L::00000000000000000000000000000000000000000000000000000000000000000000000000000000000000000000000000000000000000000000000000000MN0000000000000000000000000000000000000000000000000000000000??00000000K000000000000
BBBBB44000000000000000000000000000000000000000MN00000000000000000000000000MN000000000000000000000000000MN00000000000000000MN000000OP00000000000000000000000000000Q0000000000000000000000000000??00000000K000000000000
:G:G:::000000000E00000R0?000000000000000000000OP0000SE00000000000000000000OP000000000000000000000000000OP00000000000000000OP00MN00TU00000000000000000000000000000V00000000000000MN000000000000??00000000K000044400000
:L:L:::00000000IHI0000WX?000H00000?00000000000TU000YZJJJJJ0000000000I00000TU000JJJJ00JJJ000000000000000TU0000000000MN00000TU00OP00[\00000000000000000000000000000H00]^000_`00000OP0000000II000??00000000K00009:;00000
:::::::000000a0000000a???000000000?00000000a00[\0000b00000000a0000000a0000[\000000000000000a00000000000cd0000a00000OPa0000[\00TU00[\00000000000000000e0000?00a000000fg000hi00000TU000000000a00??00000000K0004BBB40000
G:G:G::0000j0k0000000????000lmn000??0000j00k00[\00000000000j0k0op0000k0jj0[\000000000000j00k00000000000qr0000k00000TUk0jj0[\00[\00[\0000j000000000000st000?j0k0000000k0jj0000000[\u00000j00kv0??00000000K00j::G::0000
L:wxL::0000y0yzzzz00?????000{|}000??00~€z0y00[\0000000000‚ƒ„z…†zƒ‡ˆ‰Šyy0[\000000‹ŒŽzyz0y0000000‘00[\0000yzz’“0”•y–—y0[\00[\00[\00zzyz00000000000˜™000?y0yzš›œ000y0yy0000000[\000zzyz0yž0??00000000?00y::L::z000
ŸŸ ¡ŸŸŸŸŸŸŸŸŸŸŸŸŸŸŸŸŸŸŸŸŸŸŸŸ¢Ÿ£ŸŸŸŸŸŸŸ¤¥¦ŸŸŸŸŸŸŸŸŸŸŸŸŸŸŸŸŸ§¨©ŸŸŸªŸ©¥«¬ŸŸŸŸŸŸŸŸŸŸŸŸŸ­®¯­ŸŸŸŸŸ0000ŸŸŸ°ŸŸŸŸŸŸ000ŸŸŸŸ±ŸŸŸŸ¥«ŸŸŸŸŸŸŸŸŸŸŸŸŸŸŸŸŸŸŸ000ŸŸŸŸŸŸŸŸŸŸ00ŸŸŸŸŸ²³´ŸŸŸŸŸŸŸŸŸŸŸŸŸŸŸŸ£ŸŸŸŸŸŸŸŸŸŸŸŸŸŸŸŸŸŸŸŸŸŸŸŸŸŸŸŸŸŸŸŸŸŸ
