------------------------------------------------------------------------------------------------------------------------------------------------------------------1--------------------------------------
-222----------------------------------------------------------------------------------------------------------------------------------------------------------------------------------------------------3
-456------------------------------------------------------------------------------------------------------------------------------------------------------------------------------------------77-------89
2:::2-----------------------;----------------------------------------<-------------------------------------------------------=----------------------------------------------=-----------------77-------->
55?55-----------------------@AAA---------------------BBBBB-----------@AAA--------AA@AA------AAAA-----------------------------@AAA-----------------------------------AAAAA---@-------------@---77--------C
55D55-----------------------------------------------------------------------------------------------------------------------------EF----------------------------------------------------------77--------C
:::::22---------------------------------------EF--------------------------EF---------------------------EF-----------------EF------GH-----------------------------I----------------------------77--------C
5?5?555---------=-------7---------------------GH----J=--------------------GH---------------------------GH-----------------GH--EF--KL-----------------------------M--------------EF------------77--------C
5D5D555--------A@A----N77---@-----7-----------KL---OPBBBBB----------A-----KL---BBBB--BBB---------------KL----------EF-----KL--GH--QR-----------------------------@--ST----B-----GH-------AA---77--------C
5555555---------------777---------7-----------QR----U---------------------QR---------------------------QR----------GH-----QR--KL--QR-----------------V----7---------WX----Y-----KL------------77--------C
?5?5?55--------------7777---Z[\---77----------QR---------------]^---------QR---------------------------QR----------KL-----QR--QR--QR-----------------_`---7---------------a-----QRb---------c-77--------C
D5D5D55-------------77777---def---77--ghi-----QR----------jkgl-mn-opqrs---QR------tuvwx------------yz--QR--------{-QR-|q--QR--QR--QR-----------------}~---7----ÄÅ--------------QRÇ---------É-77--------7
ÑÑÑÑÑÑÑÑÑÑÑÑÑÑÑÑÑÑÑÑÑÑÑÑÑÑÑÑÖÑÜÑÑÑÑÑÑÑáàâÑÑÑÑÑÑÑÑÑÑÑÑÑÑÑÑÑäãåÑÑÑçÑåéèêÑÑÑÑÑÑÑÑÑÑÑÑÑëíìëÑÑÑÑÑ----ÑÑÑîÑÑÑÑÑÑ---ïïïïñÑÑÑÑéèÑÑÑÑÑÑÑÑÑÑÑÑÑÑÑÑÑÑÑ---ÑÑÑÑÑÑÑÑÑÑ--ÑÑÑÑÑóòôÑÑÑÑÑÑÑÑÑÑÑÑÑÑÑÑÜÑÑÑÑÑÑÑÑÑÑÑÑÑÑÑÑÑÑÑÑÑÑ
