----------------------------------------------------------------------------------------------------------------------------------------------------------------------------------------------------------------------------------
---------------------------------------------------------------------------------------------------------------------------------------------------------------------------------------------------------------------------------1
--------------------------------------------------------------------------------------------------------------------------------------------------------------------------------------------------------------------------------23
-------------------------------------------------------------45----------66-------7-------------------8----------------------------------------------------------------------------------9:--------------------------------------;
---------------------------<--------6666---------------6-6-6-=>---------6--6-----?@--------------666--A-----666-------------B--------666666CD--------------------------------------------EF----------------------------GG--------H
---------------------------IJ---------------------------6-6--------------------------------------KL------------------------MN--------------OP-----------QR-------------------66666------------------------------------GGG--------H
-------------------------------------------------------------------------------------------------ST-----------------------------------------------------UV---------------------WX------------------------------------GGGG--------H
-YYY-------------------------------------------Z[--------------------\]-----------------------------^^^^^--------------------------------------------6666----------------------_`-----------------------------------GGGGG--------H
-abc-----------^^^^^^^^^^^^^^^^-^^^^^^^^^^^^^^^de^^^^^^^^^^^^^^^-----fg^^^^^^^^------^^^^^^^^^^----GhhhhhG----------------^^^---^^^^^^^^^^^^^^^-----------------^^^^^^^^---^^--^^--^^---^^^^^^^^^------------------GGGGGG--------H
YiiiY-------GGGjjjjjjjjjjjjjjjjGjjjjjjjjjjjjjjjGjjjjjjjjjjjjjjjG----GjjjjjjjjjjG----GjjjjjjjjjjG---GkkkkkG-------lm-------jjj--GjjjjjjjnojjjjjjG---------------GjjjjjjjjG--jj--jj--jj--GjjjjjjjjjGG---------------GGGGGGG--------H
bbpbb------GGGG-qr-------------G--st-----------G---------------G----G----------G----G----------G---GkkkkkGuv-----wx------------G-------yz------G---^^^^^^^^----G---{|---G--------------G---------GGG-------------GGGGGGGG--------H
bb}bb-----GGGGG-~-------------G--ÄÅ-----------G---------------G----G----------G----G----Ç-----G---GkkkkkGÉÑ-------------------G---------------G--GjjjjjjjjG---G--------G--------------G---------GGGG-----------GGGGGGGGG--------G
ÖÖÖÖÖÖÖ-Üááááááà---------------G---------------G---------â-----G----G----------G----G---äã-----G---GkkkkkG------Üááááááà-------G---------------G--G--------G---G--------G--------------G-åç-----Üáááááááááááà--ÖÖÖÖÖÖÖÖÖÖÖÖÖÖÖÖÖÖÖ
