------------------------------------------------------------------------------------------------------------------------------------------------------------------------------------------------------------------------------
---------------------------123---------------123---------------------------123---------------123---------------------------123---------------123---------------------------123---------------123-----------------4---------123
1223--------------123------5671223-----------5671223--------------123------5671223-----------5671223--------------123------5671223-----------5671223--------------123------5671223-----------5671223------------89123------567
5667--------------567---------5667--------------5667--------------567--------:5667--------------5667--------------567---------5667--------------5667--------------567---------5667--------------5667-------------;567---------
------------------------------------------------------------<----------------=------------------------------------------------------------------------------------------------------------------------->>--------;------------
------------------------------------------------------------?-----------------------------------------------------------------@-----------------------------------------AAAA-------------------------->>>--------;------------
-----------------------------------------------------------------------------B----------------------------------------------------------------------------------------------------------------------->>>>--------;------------
-CCC-------------------------------------------------------------------------D-------------------------------------------------------------------------------------------EF------------------------->>>>>--------;----CCC-----
-GHI---------------------------------------------------AAA-------------------=--------------JK---------------------------------------------------------------------------LM------------------------>>>>>>--------;----GHI-----
CNNNC--------O-------O---------------------O---------------->O-------O---------------------OPQ---------------O-------O---------------------O-----------------O-------O---RS----------------O------>>>>>>>----O---;---CNNNC----
HHTHH------U-V-W-----V-UU-------XY------U-Z[\--------------U>V--]^---V-UU-->]_->--------U--V---------------U-`-------V-UU----->-----a---U-bcdef------gh----U-V--i-jk-V-UUlm-------------U--V----->>>>>>>>--U-V---;---HHTHH----
HHnoH------p-pqrsq---p-tuvwx----yz{---qqpq|}~---->---------p>pqq€-‚ƒ„…p-->†‡->------qqpq-p---------------pˆ‰qqqq--…Š‹…----->-----ŒqqpqŽ‘’------“”----p-pqq•–—˜™p-pplm------š›œžqqpŸ ¡---->>>>>>>>>--p-pqqq>---HH-HH----
¢¢£¤¢¢¢¢¢¢¢¢¢¢¢¢¥¢¢¢¢¢¢¦§¨¦§¢¢¢¢¢©¢¢¢¢¢¢¢¢ª¥©¢¢¢¢¢¢¢¢¢¢¢¢¢¢¢¢¢¢¢¢©¢«¬­«¬¢¢¢¢¢®¢¢--¢¢¢¢¢¢¢¢¢¢¢¢¢¢¢¢¢¢¢¢¢¢¢¢¢¢¢®¢¢¢¢¢¢«¬¯«¬¢¢--¢¢¢--¢¢®¢¢¢¢¢¢¢®¢¥¢¢¢¢¢¢¢ª¢¢¢¢¢¢¢¢¢¢¢®¢¥¢¢¢¢¢¢¢¢¢¢¢¢°±²³¢¢¢¢´µ¶¢¢¢¢¢¢¢¢¢¢¢¢¢¢¢¢¢¢¢¢¢¢¢¢¢¢¢¢¢¢¢¢¢¢
