0000000000000000000000000000000000000000000000000000000000000000000000000000000000000000000000000000000000000000000000000000000000000000000000000000000000000000000
0000000000000000001223000000000000000000000000000400000055000000001223000000000000677777780000000000000000000000001223000000000000000000067778000000000900000:::001
000122300000000000;<<=000000000000000000000000000>01223?@@A0000000;<<=000000005000B000000B000000000122300000000000;<<=0000000000000000000B000B00000122CD00000EFG00;
000;<<=00000000000000000000HIJ000000000000000000000;<<=0KK0000000000000000000?@A00B000000B000000000;<<=0055000000000000000000000000000000B000B00000;<<=L0000:MMM:00
00000000000000000000000000000000000000000000000000NO0000KK00000000000000000000K005B000005B50000PPP000000?@@A000000Q000000000000000000000RRR00B000000000S0000FFTFF00
0000000000000000000000000UV00000000005123055500000WX0000KK00YYY000500050005000K00RRR00123B000000000000000KK0050000Z00000000000000[\\]01230000B000000000S0000FF0FF00
0000000001230000000000?@@@@A0000000123;<=000000?@@@^A000KK2300000?@A0?@A0?@A00K0000123;<=B000000000000000KK3?@A00000000000000000000123;<=0000B000000000S01::MMMMM::
0:::00000;<=00000000000KKKK000_``a0;<=0000000000KKKK0000KK<=000000K000K000K000K0000;<=00RRR00000000000000KK=0K000000000000b0c000000;<=000000RRR00000000S0;FFFTFTFFF
0EFG0000000000000000000KKKK0000000000000000?@@A0KKKK5d50KK00000000K000K000K000K0000000000000effg0?@A00000KK00K000000000000hijk0000000000000000000000000S00FFF0F0FFF
:MMM:0000000000000?@@@AKKKK00000000000000000KK00KKKK0lm0KK00000000K000K000K000K0000000000000000000K000000KK05K000000000?@@nopq@@@@A00000000000000000000S00FFFFFFFFF
FFTFF00000000000000KKK0KKKK01230000000000000KK?@@@@@@roAKK00000000K000Kst0K012K00000?@@A0000001230K0uvvw0KK?@@@A00000000KKKKKKKKKK000000000000123000000S00FFTFTFTFF
FFxyF00000000000000KKK0KKKK0;<=55000?@@@@@A0KK;KKKKKKKK0KK00000000K000Kz{0K0;<K000000KK0000000;<=0K000000KK0KKK000000000KKKKKKKKKK000000000000;<=000000|00FF0F0F0FF
}}~}}}}}}}}}}}}000KKK0KKKK000?@A0000KKKKK00KK0KKKKKKKK0KK0000000?@@@@@€@@@@@@@A0000KK00000000000K000000KK0KKK00000?@A0KKKKKKKKKK00000000000000}}}}}}}}}}}}}}}}}}}
