-------------------------------------------------------------------------------------------------------------------------------------------------------------------
------------------1223---------------------------4------55--------1223------------67777778------------------------1223-------------------67778---------9-----:::--1
---1223-----------;<<=--------------------------->-1223?@@A-------;<<=--------5---B------B---------1223-----------;<<=-------------------B---B-----122CD-----EFG--;
---;<<=--------------------HIJ---------------------;<<=-KK-------------------?@A--B------B---------;<<=--55------------------------------B---B-----;<<=L----:MMM:--
--------------------------------------------------NO----KK--------------------K--5B-----5B5----PPP------?@@A------Q---------------------RRR--B---------S----FFTFF--
-------------------------UV----------5123-555-----WX----KK--YYY---5---5---5---K--RRR--123B---------------KK--5----Z--------------[\\]-123----B---------S----FF-FF--
---------123----------?@@@@A-------123;<=------?@@@^A---KK23-----?@A-?@A-?@A--K----123;<=B---------------KK3?@A--------------------123;<=----B---------S-1::MMMMM::
-:::-----;<=-----------KKKK---_``a-;<=----------KKKK----KK<=------K---K---K---K----;<=--RRR--------------KK=-K------------b-c------;<=------RRR--------S-;FFFTFTFFF
-EFG-------------------KKKK----------------?@@A-KKKK5d5-KK--------K---K---K---K-------------effg-?@A-----KK--K------------hijk-------------------------S--FFF-F-FFF
:MMM:-------------?@@@AKKKK-----------------KK--KKKK-lm-KK--------K---K---K---K-------------------K------KK-5K---------?@@nopq@@@@A--------------------S--FFFFFFFFF
FFTFF--------------KKK-KKKK-123-------------KK?@@@@@@roAKK--------K---Kst-K-12K-----?@@A------123-K-uvvw-KK?@@@A--------KKKKKKKKKK------------123------S--FFTFTFTFF
FFxyF--------------KKK-KKKK-;<=55---?@@@@@A-KK;KKKKKKKK-KK--------K---Kz{-K-;<K------KK-------;<=-K------KK-KKK---------KKKKKKKKKK------------;<=------|--FF-F-F-FF
}}~}}}}}}}}}}}}---KKK-KKKK---?@A----KKKKK--KK-KKKKKKKK-KK-------?@@@@@€@@@@@@@A----KK-----------K------KK-KKK-----?@A-KKKKKKKKKK--------------}}}}}}}}}}}}}}}}}}}
