0000000000000000000000000000000000000000000000000000000000000000000000000000000000000000000000000000000000000000000000000000000000000000000000000000000000000000000000000000000000000000000000000000000000000000000000000000000000000000000000
0111000000000000000234000000000005002334000000000000000000000000000234000000000000002334000000000000000000000000000234000000000000002334000000000000000000000000000234000000000000002334000000000000000000000000000234000000000006002334000000
0789000023400000000:;<00000233340=00:;;<000000000000000023400000000:;<00000233340000:;;<000000000000000023400000000:;<00000233340000:;;<000000000000000023400000000:;<00000233340000:;;<000000000000000023400000000:;<0000023334>?00:;;<000000
1@@@1000:;<0000000000000000:;;;<0A0000000000000000000000:;<0000000000000000:;;;<000000000000B00000000000:;<0000000000000000:;;;<000000000000000000000000:;<0000000000000000:;;;<000000000000000000000000:;<0000000000000000:;;;<0C000000000000
88D8800000000000000000000E00000000000000000000000000000000000000E0E0000000000000000000000000F0000000000000000000000000000000000000000000000000000000EEEE000000000000000000000000000000000000000000000000000000000000000GG00000000H000000000000
88I880000000000000000000000000J00000000000000000000000000000000000000000000000000000000000000000000000000KKKK0000000000KKKK000000000000KKKK000000000000000000000000000000000000000000000000000000000000000000000000000GGG00000000H000000000000
@@@@@110000000000000000000000000000000000000000000000000000000000000000000000000000000000000000000000000000000000000LM00000000000000LM0000000000000000000000000000000000000000000000000000000000000000000000000000000GGGG000N0000H000000000000
8D8D88800000000000000LM00O0000000000000000KK000000000000000000000000000000000000000000000000000000000000000000000000PQ00000000000000PQ00000000000000O000000000000000000000000000000000000000000000000000000000000000GGGGG000R0000H000011100000
8I8I88800000000000000PQ00E000000000000000K00K0000000000000000000E0E00000000000000000000000EEEE0000000000000000000000ST00000000000000ST000000000000EEEUUEEE000000000LM0000000000000000000000000000000000000000000000GGGGGG000F0000H000078900000
888888800000000000000ST000000000000000000000000000V00000000000000000000000000000000000000000000000V0000G000000000000WX00000000000000YZ000000000000V0000000000000000PQ000000000000000000000000G0000V000000000000000GGGGGGG00000000H0001@@@10000
D8D8D880000000000V000WX00000000000000000000000000[I\0000000000000V0000000000000000000000000000000[I\000G000000000V00WX00000000000000]^00000000000[I\0000000000000V0ST000000000000000000000000G000[I\0000000000000GGGGGGGG00000000H00088D880000
I8_`I880000abbbc[I\00WXabc0de000000000000abbc000[III\000000abbbc[I\0000abc000000000000000abbc000[III\00G000abbbc[I\0WX0abc0000000000WX000abbc000[III\000000abbbc[I\fg00abc000000000000000abbcG00[III\000000abbbcGGGGGGGGGc0000000G00088I88bbc0
hhijhhhhhhhhhhhhhhhhhhhhhhhkhhhh00hhhhhhhhhhhhhhhhhhhhhhhhhhhhhhhhhhhhhhhhhhhh0000hhhhhhhhhhhhhhhhhhhhhhhhhhhhhhhhhhhhhhhhhhhhhhhhhhhhhhhhhhhhhhhhhhh00hhhhhhhhhhhhhhhhhhhhhhh000hhh00hhhhhhhh00hhhhhhhhhhhhhhhhhhhhhhhhhhhhhhhhhhhhhhhhhhhhhh
