----------------------------------------------------------------------------------------------------------------------------------------------------------------------------------------------------------------------------------
-111-----------------------------2-----------------------------------------------------------------------------------------------------------------------------------------------------------------------------------------------3
-456-----------------------------7----------------------------------------------------------------------------------------------------------------------------------------------------------------------------------------------89
1:::1----------------------------;----------------------------------------------------------<------------------------------------------------------------------------------------------------------------------------------------=
55>55--------------------?--------------------------------------?-?-------------------------@-------------------------------------------------------????---------------------------------------------------------------AA--------B
55C55-------------------------D--------------------------------------------------------------------------EEEE----------EEEE------------EEEE---------------------------------------------------------------------------AAA--------B
:::::11-------------------------------------------------------------------------------------------------------------FG--------------FG-------------------------------------------------------------------------------AAAA---H----B
5>5>555--------------FG--I----------------EE------------------------------------------------------------------------JK--------------JK--------------I---------------------------------------------------------------AAAAA---L----B
5C5C555--------------JK--?---------------E--E-------------------?-?-----------------------????----------------------MN--------------MN------------???OO???---------FG----------------------------------------------AAAAAA---@----B
5555555--------------MN--------------------------------------------------------------------------------A------------PQ--------------PQ-----------------------------JK------------------------A--------------------AAAAAAA--------B
>5>5>55--------------PQ--------------------------------------------------------------------------------A------------PQ--------------PQ-----------------------------MN------------------------A-------------------AAAAAAAA--------B
C5C5C55--------------PQ----RS--------------------------------------------------------------------------A------------PQ--------------PQ-----------------------------PQ------------------------A------------------AAAAAAAAA--------A
TTTTTTTTTTTTTTTTTTTTTTTTTTTUTTTT--TTTTTTTTTTTTTTTTTTTTTTTTTTTTTTTTTTTTTTTTTTTT----TTTTTTTTTTTTTTTTTTTTTTTTTTTTTTTTTTTTTTTTTTTTTTTTTTTTTTTTTTTTTTTTTTT--TTTTTTTTTTTTTTTTTTTTTTT---TTT--TTTTTTTT--TTTTTTTTTTTTTTTTTTTTTTTTTTTTTTTTTT
