654222322100
622254322371
654222354321
622254322381
654222322100
622222100000
622222100000
600000000000
600000000000
600000000000
600000000000
600000000000
600000000000
600000000000
600000000000
600000000000
600000000000
600000000000
600000000000
600000000000
600000000000
6<<;:9000000
6@@?>=000000
600000000000
600000000000
6000AB00A000
600000000000
DC0000000000
6E0000000000
600000000000
6000000F0000
600000000000
000000000000
000000000IHG
600000000000
600000000000
600000000000
600000000000
600000000000
600000000000
600000000000
6000J0000000
60000J000000
60000J000000
6000J0000000
600000000000
600000000000
600000000000
600000000000
600000000000
600000000000
600000000000
600000000000
600000000000
600000000000
600000000000
600000000000
600000000000
600000000000
600000000000
600000000000
600000000000
600000000000
600000000000
6000A000A000
600000000000
6000A000A000
600000000000
600000000000
600000000000
600000000000
600000000000
600000000000
600000000000
600000000000
600000000000
600000000000
600000000000
000000000000
000000000000
000000000000
000000000000
600000000000
600000000000
600000000000
600000000000
600000000000
600000000000
600000000000
600000000000
6000A0000000
6000A0000000
6000A000LK00
6000A0000000
600000000000
600000000000
600000000000
600000000000
600000000000
600000000000
600000000000
600000000000
600000000000
6MMM00000000
600000000000
6000000J0000
6000000J0000
6000000J0000
6000000J0000
600000000000
600000000000
600000000000
600000000000
600000000000
600000000000
600000000000
6<<<;:900000
6@@@?>=00000
600000000000
6000000J0000
6000000J0000
6000000J0000
6000000J0000
600000000000
600000000000
600000000000
600000000000
600000000000
600000000000
600000000000
600000000000
600000000000
6<<<;:900000
6@@@?>=00000
600000000000
6000000J0000
6000000J0000
6000000J0000
6000000J0000
600000000000
600000000000
600000000000
600000000000
600000000000
600000000000
600000000000
6000A0000000
6000A0000000
6000AB00A000
0000N000A000
0000N000A000
6000A000A000
6000A0000000
6000A0000000
600000000000
600000000000
600000000000
600000000000
600000000000
600000000000
600000000000
600000000000
600000000000
6<;:90000000
6@?>=0000000
600000000000
600000000000
600000000000
600000000000
600000000000
600000000000
600000000000
600000000000
600000000000
000000000000
000000000000
000000000000
600000000000
600000000000
600000000000
000000000000
000000000000
600000000000
600000000000
600000000000
600000000000
600000000000
600000000000
600000000000
6MMM00000000
000000000000
000000000000
600000000000
600000000000
600000000000
600000000000
600000000000
600000000000
600000000000
600000000000
600000000000
600000000000
600000000000
600000000000
600000000000
600000000000
600000000000
600000000000
6M0000000000
6MM000000000
6MMM00000000
6MMMM0000000
6MMMMM000000
6MMMMMM00000
6MMMMMMM0000
6MMMMMMMM000
6MMMMMMMM000
600000000000
600000000000
600000000000
6000LPO00000
600000000000
600000000000
600000000000
6000000000Q0
6MUUUUUUUTSR
