-----------------------------------------------------------------------------------------------------------------------------------------------------------1223-----------------------------------------------------------------
-------------------------------------------4--------------------56---------------------------------------------------------------------------------------------------------------------------78---------------------------------
--9:---------------------------------------;--------------------<=---------------------------------------------------------------------------------------------------------------------------78---------------------------------
-->?------------------------------------------------------@AAB--<-------------CD----------------------------------------E-----------------------------------------------------------CD-------78---------------------------------
--------------------------------------------------FF--------------------------GH----------------------------------------------------------------------------------------------------GH-------78---------------------------------
------------------------------------------------------------------------------IJ-------------------------------------------KLLM-----------------------------------------------------IJ-------78-------------------NOPQRSTUVWX---
-----------------------------------------------------------------------------478---------------------------CD---------------------------------CD------------------------------------78-------78---------------------------------
----------------------------E-------------YZ[Y---------E----------------CD---;78-\--CD---CD----------------GH-----------------------------CD--GH-----------------E]]]]]]]]]]--------78-----^_`8-----------------------a---------
------------------------------------------bcdb----FF--FFF---------------GH----78----GH---GH----------------IJ-----effg-------------CD-----GH--IJ--------------------------------h---78-----ijk8---------------------------------
------------------------------------------------------------------------IJ----78----IJ---IJ-------------h--78--hh------------------GH-----IJ--78----------h--------------------hh---78--------------------------------IJ--------
------------------------------------------------------------------------78-l--78----mn---78-------opq--hh--78--hh------------------IJ--r--78--78-------sthhKLLM--------u-v----hhh---78--------------------------------78--------
---------------------------]]]------------------------------------------78-w--78-xy-z{-xy78-------|}~-hh--78--hh------------------€--‚ƒ-78--78-------„…hh------------†‡ˆ---hhhh-‰Š78--------------------------------78--------
‹‹‹‹‹‹‹‹‹‹‹--‹‹--‹---‹‹‹‹‹‹‹‹‹‹‹‹‹‹‹‹‹‹‹‹‹‹‹‹‹‹‹‹‹‹‹‹‹‹‹‹------‹‹‹‹‹‹‹‹‹‹‹‹Œ‹‹‹‹‹‹‹‹‹‹‹‹‹‹‹‹‹‹‹‹‹Ž‹‹‹--‹‹--‹‹------‹‹‹‹------‹‹‹‹‹‹‘’‹‹‹‹‹‹‹--‹‹‹‹‹‹‹‹‹-----‹‹‹‹‹‹‹“”•‹‹‹‹‹‹‹‹–‹‹‹‹--‹‹‹‹‹‹‹‹‹‹‹‹‹‹‹‹‹‹‹‹‹‹‹‹‹‹‹‹‹‹‹‹‹‹‹‹‹‹‹
