322100000000
322541000000
376521000000
322581000000
322100000000
300000000000
300000000000
300000000000
300000000000
300000000000
300000000000
300000000000
300000000000
300000000000
3:9000000000
=<;000000000
300000000000
?>0000000000
A@0000000000
CB0000000000
ED0000000000
GF0000000000
300000000000
300000000000
300000000000
300000000000
300000000000
300000000000
IH0000000000
KJ0000000000
ML0000000000
ON0000000000
QP0000000000
300000000000
300000000000
300000000000
300000000000
3SR000000000
UT0000000000
V00000000000
V00000000000
V00000000000
V00000000000
V00000000000
[ZZYXW000000
3__^]\000000
300000000000
300000000000
300000000000
000000000000
000000000000
3ZZYa`000000
3__^cb000000
300000000000
300000000000
300000000000
300000000000
300ed0000000
300000000000
300000000000
300000000000
300000000000
300000000000
gf0000000000
ih0000000000
kj0000000000
ml0000000000
300000000000
300000000000
300000000000
300000000000
300000000000
on0000000000
?p0000000000
rq0000000000
gf0000000000
3s0000000000
300000000000
300000000000
300000000000
300000000000
300000000000
300000000000
300ut0000000
300wv0000000
300000000000
300000000000
300000000000
300000000000
3xxxx0000000
3000x000y000
3000x000{z00
0000x000y000
0000x0000000
000000000000
000000000000
300000000000
300000000000
300000000000
300000000000
300000000000
300000000000
}|0000000000
~0000000000
ÅÄ0000000000
on0000000000
3Ç0000000000
300000000000
300000000000
300000000000
300000000000
3ÑÉ000000000
300000000000
300000000000
000000000000
000000000000
3xxx00000000
300000000000
300000000000
}|0000000000
~0000000000
ÅÄ0000000000
ÜÖ0000000000
àá0000000000
300000000000
3äâ000000000
çåã000000000
300000000000
300000000000
300000000000
300000000000
300000000000
3é0000000000
êè0000000000
300000000000
300000000000
300000000000
300000000000
300000000000
300000000000
300000000000
300000000000
300000000000
3íë000000000
ïîì000000000
òóñ000000000
3ô0000000000
3xxxx0000000
3000{ö000000
3000y0000000
3000y0000000
300000000000
000000000000
000000000000
000000000000
300000000000
3000xõYXW000
3000xú^]\000
30000ûù00000
3ÑÉ000000000
300000000000
300000000000
300000000000
3õYXW0000000
3ü^]\0000000
300000000000
300000000000
300000000000
300000000000
300000000000
3ÑÉ000000000
300000000000
300000000000
300000000000
300000000000
30¢°†0000000
30§£00000000
300000000000
300000000000
300000000000
300¶•0000000
300ßì0000000
3x0000000000
3xx000000000
3xxx00000000
3xxxx0000000
3xxxxx000000
300000000000
300000000000
300xxxxxx000
300xxxxxx000
300000000000
300000000000
300000000000
300000000000
300000000000
300000000000
300000000000
3000000000®0
3x¨¨¨¨¨¨¨´™©
