----------------------------------------------------------------------------------------------------------------------------------12---------------------------------------------------------------------
--------------------------------------------------------------------------------------------------------------------------------------------------------------------------------------------------------3
------------------------------------------------------------------------------------------------------------------------45----------------------------------6------------------------------------------78
---------------------999----------:---------------------------------------------------99--------------------------------;<---=------------------------------>?--------------99--------------------------@
-----------------------------AAAAAB--------------------------------------------------BAA------------------------------AAAAAAAC---------------------------AAAAA--------------AAAA--------------DD--------@
---------------------------------------------------------------------------------E-----------------------------------------------------------------------------------------------------------DDD--------@
-----------------F---------------------------------------------------DD----------G----------------------------------------HI-------------------------------------------------------------JK--DDD--------@
-LLL-------------M-----------999-----------------------NO-----------DDD------------------AAA------------------------------PQ--------------------------------------------:----------------RSD-DDD--------@
-TUV-----------DDDD----------AAAAAA---WX-----Y-DD------Z[--------D--DDD-------\\\\\-B--------------------]^--------NO-AAAAAAAA---------------_-----AAA--------------`ab-B----NO-----------DD-DDD--------@
LcccL---------DD----------------------de-----fDDD------gh------iDD--DDD----------jk----------------------lm--------Z[------------D-----------n:---------------------opq------Z[-----------DD-DDD--------@
UUrUU--------DDD----s----t------------uv-----DDDDD-----wx------yDD--DDD----------z{------------------------F-------gh------------D-----------BB------------------------------gh---------D-DD-DDD--------@
UU|UU-------DDDD----}~---------------------DDDDDD-----wx---€DDDD--DDD------------------99----------------M-------wx------------D------------------------i‚ƒ----------------wx--------DD-DD-DDD--------„
……………………………………………………†‡…………---…………………………………………………………………………………ˆ‰…………--………………………………………………………………----…………………………………………………………………………………--……………‹…………………-------……………………………………………---……--……………………-……-………………………………
