000000000000000000000000000000000000000000000000000000000000000000000000000000000000012300000000000000000000000000000000000000000045000000000000000000000000000000000000000000000000000000000000000000000000000000000
000000000000000000000000000678000000000000000678000000000000000000000000000678000000019:0000067800000000000000000000000000067800000000000000067800000000000000000000000000067800000000000000067800000000;000000000000
677800000000000000678000000<=>677800000000000<=>677800000000000000678000000<=>677800010000000<=>677800000000000000678000?@0<=>677800000000000<=>677800000000A00000678000000<=>677800000000000<=>6778000BC000000000678
<==>00000000000000<=>DDD000000<==>E0000000000000<==>00000000000000<=>000000000<==>0001DD00000000<==>00000000000000<=>000FG000H<==>00000000000000<==>00000000IJ0000<=>0000000DD<==>00000000000000<==>0000K000000000<=>
00000000000000000000000000000LLLLLM00000000000000000000000000000000000000000000000000MLL000000000000000000000000000000LLLLLLLM000000000000000000000000000LLLLL00000000000000LLLL000000000N0000OO00000000K000000000000
000000000000000000000000000000000000000000000000000000000000000000000000000000000P0000000000000000000000000000000000000000000000000000000000000000000000000000000000000000000000000000000QR00OOO00000000K000000000000
000000000000000STU000000000000000000000000000000000000000000000000000OO0000000000V0000000000000000000000000000000000000000WX0000000000000000000000000000000000000000000000000000000000000YZ00OOO00000000K000000000000
0[[[0000000000000\00000000000DDD00000000000000000000000]^00000000000OOO000000000000000000LLL000000000000000000000000000000_`00000000000000000000000000000000000000000000E000000000000000000O0OOO00000000K0000[[[00000
0abc00000000000OOOO0000000000LLLLLL000de00000fgOO000000hi00000000O00OOO0000000jjjjj0M00000000000000000000kl00000000]^0LLLLLLLL000000000000000m00000LLL00000000000000nop0M0000]^00000000000OO0OOO00000000K0000abc00000
[qqq[00000000rOO00000r0000000000000000st000r0uvOO000000wx0000r0yOO00OOO0000000000z{00000000r0000000000000|}00r00000hir00000000000O000000000r0~E00000000000000r000000ÄÅ000000hi00000000000OO0OOO00000000K000[qqq[0000
bbÇbb000000É0OOO0000ÑÖ0ÉÉÜ000000000000áàÉ00Ö0OOOOO00000âä00É0Ö0ãOO00OOOÉÉ00000000åç00000É00Ö0000000000000STU0Ö00000wxÖ0ÉÉ00000000O000000É00Ö0MM000000000000É0Ö0000000Ö0ÉÉ0000wx000000000O0OO0OOO00000000K00ÉbbÇbb0000
bbéèb000000êOOOOëë00íì0êêî000000000000ëëêë0êOOOOOO00000ïñ00êóòOOOO00OOOêê0000000000000ëëêDDê000000000000000\0êëëëë0ôöê0êê00000000O0000õúùû0ê00000000000000yü†êëëëë000ê0êê0000°¢0000000ëOO0OO0OOO00000000O00êbb£bbë000
§§•¶§§§§§§§§§§§§§§§§ß®§§§§000§§§§§§§§§§§§§§§§§§§§§§§§§§§§§§§©™§§§§00§§§§§§§§§§§§§§§§§§§§§§§§0000§§§§§§§§§§§§§§§§§§§§§§§§§§§§§§§00§§§§§´¨≠§§§§§§§0000000§§§ÆØ§§§§§§§§§§§§§§000§§00§§§§§§§§0§§0§§§§§§§§§§§§§§§§§§§§§§§§
