322100000000
322541000000
376521000000
322581000000
322100000000
300000000000
300000000000
300000000000
300000000000
300000000000
300000000000
300000000000
390000000000
399000000000
399900000000
399990000000
300090000000
30009;:00000
300090000000
300000000000
>=<000000000
A@0000000?00
300000000?00
300000000?00
300000000000
3CB000000000
000000000000
000000000000
000000000000
3000D?00D000
3000D?00D000
3000D?00D000
3000D000D000
3000D000D000
3000D000FE00
300000000000
300000000000
300000000000
30IHG0000000
30LKJ0000000
300000000000
300000000000
300000000000
300000000000
390000000000
399NM0000000
399900000000
399990000000
399990000000
399000000000
300000000000
300000000000
300000000000
300000000000
300000000000
3RRQPO000000
3VVUTS000000
300000000000
300000000000
300000000000
XW0000000000
ZY0000000000
390000000000
39\[00000000
399900000000
399990000000
000000000000
000000000000
399999000000
399999900000
399999900000
300000000000
300000000000
300000000000
300000000000
300000000000
300000000000
300000000000
3000]0000000
3000]0000000
3000]0000000
30a`]0_^0000
30cb]0000000
300000000000
3000F0000000
30000000F000
30000000D?00
30000000D?00
300000000000
3?000D000000
3?000D000000
30000D000000
000000000000
000000000000
000000000000
000000000000
300000000000
300000000000
300000000000
300000000000
300000000000
300000000000
300000000000
300000000000
300000000000
300ed0000000
300gf0000000
3;:000000000
300000000000
300000000000
300000000000
300000000000
300000000000
300000000000
300000000000
3RQPO0000000
3VUTS0000000
300000000000
3000D000D000
3000D000D000
3000D000Dih0
3000D000Dkj0
3000Dml0D000
3000Don0D000
3000D000D000
3000D000qp00
300000000000
000000000000
000000000000
399900000000
300000000000
300000000000
300000000000
300000000000
r00000000000
s00000000000
t00000000000
300000000000
300000000000
300000000000
300000000000
30Fvu0000000
30FE00000000
300000000000
000000000000
000000000000
000000000000
0000D0000000
0000D0000000
0000D0000000
000000000000
300000000000
300000000000
30000000D000
w[000000D000
yx000000D000
3|000000D{z0
30000000D}00
300000000000
300000000000
300000000000
300000000000
300000000000
300000000000
300~0000000
300€0000000
300ƒ‚0000000
300000000000
3000FE000000
300000000000
000000000000
000000000000
00000000D?00
3RQPO000D?00
3VUTS000D000
00000000D000
000000000000
300000000000
300000000000
300000000000
300000000000
300000000000
300000000000
390000000000
399000000000
00000…„00000
39999‡†00000
399999000000
000000000000
399999990000
399999999000
399999999000
300000000000
300000000000
300000000000
300000000000
300000000000
300000000000
300000000000
3000000000ˆ0
3Œ‹‹‹‹‹‹‹‹Š‰
