000000000000000000000000000000000000000000000000000000000000000000000000000000000000000000000000000000000000000000000000000000000000000000000000000000000000000000000000000000000000000000000000000000000
011100000000000000023400000000005000233400000000000000000000000000023400000000000000233400000000000000000000000000023400000000000000233400000000000000000000000000023400000000000000233400600000000000000
0789000023400000000:;<0000023334=>00:;;<000000000000000023400000000:;<00000233340000:;;<000000000000000023400000000:;<00000233340000:;;<000000000000000023400000000:;<00000233340000:;;<0?@00000000000002
1AAA1000:;<0000000000000000:;;;<0000B0000000000000000000:;<0000000000000000:;;;<000000000000000000000000:;<0000000000000000:;;;<000000000000000000000000:;<0000000000000000:;;;<0000000000C0000000000000:
88D880000000000000000000000000000000EF000000000000000000000000000000000000000000000000000000000000000000000000000E00000000000000000000000000000000000000000000000000000000000000GG00000000H00000000000000
88088000000000000000000000000000000000000000000000000000000000000000000000000000000000000GFFF00000000000000000000000000000000000000000000000000000000000000000000000000000000000GG00000000H00000000000000
AAAAA11000000000000000000000000000000000000I00000000000000000000000000000000JJ0000000000GGK000000000000000000000000000000000000000B00000000000000000GFF0I00000000000000000000000GG00000000H00000000000000
8D8D888000000000000000000000000000000000000L0000000000000000000000000000000000000000000GGGE00000000000MN0JJJ000000000000000000GFF0EO000000000000000GG000L00000000000000000000G00GG00000000H00000011100000
8080888000000000OO00000000000000000GGG000FFE000000000000000000JJJ0000000GG0000000000000GGG000000000000PQ000000000E00000000000GG0000000000000000000GGG00FE0000000000000000000GG00GG00000000H00000078900000
8888888000000000000000000000000RSGGG00000000000000000000000000000000000GGG00000000000G0GGG00FFF0000000TU00000000000000000000GGG000000000000000000GGGG0000000000000000000000GGG00GG00000000H000001AAA10000
D8D8D880000000000000000000000GGGGG000000000000000000000000000000000000GGGG0000000000GG0GGG000000000000VW0000000000000000000GGGG00000000000000000GGGGG000FFF000000000000000GGGG00GG00000000H0000088D880000
08XY0880000Z[[[\0000000Z[\GGGGGG000000000Z[[\00000000000000Z[[[\00000GGGGG0000000000000GGG[[\000000000VW000Z[[[\0000000Z[\GGGGG000FFFFF00Z[[\00GGGGGG000000Z[[[\0000000Z[GGGGG00GG0000000ZG[\000880880000
]]^_]]]]]]]]]]]]]]]]00]]]]]]]]]000000]]00]]]]]]]]]]]]]]]]00]]]]]]]]]]]]]]]000]]]]]]]]]]]]]]]]000]]]]]]]]]]]]]]]]]]]]]]]]]]]]]]]0000000]]0]]]]]]]]]]]]000000]]]]]]]]]000]]]]]]]00]]]]]]]]]]]]]]]]]]]]]]]]]
