---------------------------------------------------------------------------------------------------------------------------------------------------------------------------------------------------------
-111---------------234----------5---2334---------------------------234--------------2334---------------------------234--------------2334---------------------------234--------------2334--6--------------
-789----234--------:;<-----23334=>--:;;<----------------234--------:;<-----23334----:;;<----------------234--------:;<-----23334----:;;<----------------234--------:;<-----23334----:;;<-?@-------------2
1AAA1---:;<----------------:;;;<----B-------------------:;<----------------:;;;<------------------------:;<----------------:;;;<------------------------:;<----------------:;;;<----------C-------------:
88D88-------------------------------EF---------------------------------------------------------------------------E--------------------------------------------------------------GG--------H--------------
88-88------------------------------------------------------------------------------------GFFF-----------------------------------------------------------------------------------GG--------H--------------
AAAAA11------------------------------------I--------------------------------JJ----------GGK---------------------------------------B-----------------GFF-I-----------------------GG--------H--------------
8D8D888------------------------------------L-------------------------------------------GGGE-----------MN-JJJ------------------GFF-EO---------------GG---L--------------------G--GG--------H------111-----
8-8-888---------OO-----------------GGG---FFE------------------JJJ-------GG-------------GGG------------PQ---------E-----------GG-------------------GGG--FE-------------------GG--GG--------H------789-----
8888888------------------------RSGGG-----------------------------------GGG-----------G-GGG--FFF-------TU--------------------GGG------------------GGGG----------------------GGG--GG--------H-----1AAA1----
D8D8D88----------------------GGGGG------------------------------------GGGG----------GG-GGG------------VW-------------------GGGG-----------------GGGGG---FFF---------------GGGG--GG--------H-----88D88----
-8XY-88----Z[[[\-------Z[\GGGGGG---------Z[[\--------------Z[[[\-----GGGGG-------------GGG[[\---------VW---Z[[[\-------Z[\GGGGG---FFFFF--Z[[\--GGGGGG------Z[[[\-------Z[GGGGG--GG-------ZG[\---88-88----
]]^_]]]]]]]]]]]]]]]]--]]]]]]]]]------]]--]]]]]]]]]]]]]]]]--]]]]]]]]]]]]]]]---]]]]]]]]]]]]]]]]---]]]]]]]]]]]]]]]]]]]]]]]]]]]]]]]-------]]-]]]]]]]]]]]]------]]]]]]]]]---]]]]]]]--]]]]]]]]]]]]]]]]]]]]]]]]]
