------------------------------------------------------------------------------------------------------------------------------------------------------------------12-----------------------------------------------------------------
-------------------345--------------3445---------------------------345-----------67-3445---------------------------345--------------3445---------------------------345--------------3445---------------------------345--8-----------3
--------345--------9:;--<--34445----9::;----------------345--------9:;-----34445-=>-9::;----------------345--------9:;-----34445----9::;----------------345--------9:;-----34445----9::;----------------345--------9:;-?@--34445----9
--------9:;-------------A--9:::;BC----------------------9:;----------------9:::;-=----------------------9:;----BC----------9:::;------------D-----------9:;------------BC--9:::;------------------------9:;-------------E--9:::;-----
-----------------------FGF------HI----------------------------BC---FFFFF-----FFFFG-----BC----------------------HI--F---FFFFFFFFF------------GF---FF-------------FFF----HI--------------------------------JK---LL--------M------------
--------------------------------NO----------------------BC----HI-----------------------HI----------------------NO------------------------------------------------------NO--------------------------------PQ--LLL--------M------------
-------------------BC-------BC--RS------------BC--------HI----NO-----------------------NO-------------BC-------RS-----T------------------------------------------------RS-----BC-------BC----------------BC-LLLL--------M------------
-UUU---------------HI-------HI--LL------------HI----V---NO----RS----------------BC-----RS-----BC------HI-------RS----WX-------------------FF-------------BC------------RS-----HI-----BCHI----BC----------HILLLLL--------M----UUU-----
-YZ[------FFF------NO---G---NO-----BCBC-------NO---FG---RS----LL---BC-----BC----HIG-BC-RS-----HI------NO-BC---FLLF-BC--------------BC--BC-------FFF------HI-L---FFF----LL-----NO---BCHINO----HI----------NOLLLLL--------M----YZ[-----
U\\\U--------------]^-------RS-----HIHI-------RS--------_`---------HI-----HI----NO--HI-RS-----NO------RS-HI--------HI--------------HI--HI--------------L-NO-L-----------------RS---HINORS----NO----------RSLLLLL--------M---U\\\U----
ZZaZZ--------------bc---d---RS-----NONO-------RS--------RS---------NO-----NO----RS--NO-RS-----RS------RS-NO--------NO--------------NO--NO-------------LL-ef-LL----------------RS---NORSRS----RS---------LRSLLLLL--------M---ZZaZZ----
ZZghZ------ijjjk---RS--ilm--RS-----noRS--ijjk-RS---pq---RS-ijjjk---RS--ijkRS----RS--RS-RSijrs-RS------RS-RSijjjk---no--ijk---------RS--RSijjk--------LLL-tuiLLvw------xyjk----RS---z{RSRSijjkRS--------LLRSLLLLL-------iLk--ZZ-ZZ----
||}~||||||||||||||||||||||||||||||||||||||||||||||Ä||||||||||||||||||||||||||||||||||||||Å||||||||||||||||||||||||||||||------||||||||||||-|-||||||||-|||||Ç|||||||ÉÑ|||||||||||||||||||||||||||||||||||||||||||||||||||||||||||||
