0000000000000000000000000000000000000000000000000000000000000000000000000000000000000000000000000000000000000000000000000000000000000000000000000000000000000000001200000000000000000000000000000000000000000000000000000000000000000
0000000000000000000345000000000000003445000000000000000000000000000345000000000006703445000000000000000000000000000345000000000000003445000000000000000000000000000345000000000000003445000000000000000000000000000345008000000000003
00000000345000000009:;00<003444500009::;0000000000000000345000000009:;00000344450=>09::;0000000000000000345000000009:;000003444500009::;0000000000000000345000000009:;000003444500009::;0000000000000000345000000009:;0?@003444500009
000000009:;0000000000000A009:::;BC00000000000000000000009:;00000000000000009:::;0=00000000000000000000009:;0000BC00000000009:::;000000000000D000000000009:;000000000000BC009:::;0000000000000000000000009:;0000000000000E009:::;00000
00000000000000000000000FGF000000HI0000000000000000000000000000BC000FFFFF00000FFFFG00000BC0000000000000000000000HI00F000FFFFFFFFF000000000000GF000FF0000000000000FFF0000HI00000000000000000000000000000000JK000LL00000000M000000000000
00000000000000000000000000000000NO0000000000000000000000BC0000HI00000000000000000000000HI0000000000000000000000NO000000000000000000000000000000000000000000000000000000NO00000000000000000000000000000000PQ00LLL00000000M000000000000
0000000000000000000BC0000000BC00RS000000000000BC00000000HI0000NO00000000000000000000000NO0000000000000BC0000000RS00000T000000000000000000000000000000000000000000000000RS00000BC0000000BC0000000000000000BC0LLLL00000000M000000000000
0UUU000000000000000HI0000000HI00LL000000000000HI0000V000NO0000RS0000000000000000BC00000RS00000BC000000HI0000000RS0000WX0000000000000000000FF0000000000000BC000000000000RS00000HI00000BCHI0000BC0000000000HILLLLL00000000M0000UUU00000
0YZ[000000FFF000000NO000G000NO00000BCBC0000000NO000FG000RS0000LL000BC00000BC0000HIG0BC0RS00000HI000000NO0BC000FLLF0BC00000000000000BC00BC0000000FFF000000HI0L000FFF0000LL00000NO000BCHINO0000HI0000000000NOLLLLL00000000M0000YZ[00000
U\\\U00000000000000]^0000000RS00000HIHI0000000RS00000000_`000000000HI00000HI0000NO00HI0RS00000NO000000RS0HI00000000HI00000000000000HI00HI00000000000000L0NO0L00000000000000000RS000HINORS0000NO0000000000RSLLLLL00000000M000U\\\U0000
ZZaZZ00000000000000bc000d000RS00000NONO0000000RS00000000RS000000000NO00000NO0000RS00NO0RS00000RS000000RS0NO00000000NO00000000000000NO00NO0000000000000LL0ef0LL0000000000000000RS000NORSRS0000RS000000000LRSLLLLL00000000M000ZZaZZ0000
ZZghZ000000ijjjk000RS00ilm00RS00000noRS00ijjk0RS000pq000RS0ijjjk000RS00ijkRS0000RS00RS0RSijrs0RS000000RS0RSijjjk000no00ijk000000000RS00RSijjk00000000LLL0tuiLLvw000000xyjk0000RS000z{RSRSijjkRS00000000LLRSLLLLL0000000iLk00ZZ0ZZ0000
||}~||||||||||||||||||||||||||||||||||||||||||||||Ä||||||||||||||||||||||||||||||||||||||Å||||||||||||||||||||||||||||||000000||||||||||||0|0||||||||0|||||Ç|||||||ÉÑ|||||||||||||||||||||||||||||||||||||||||||||||||||||||||||||
