-------------------------------------------------------------------------------------1-----------------------------------------------------------------2----------------------------
-333---------------------------------------------------------------------------------45----------------------------------------------------------------6---------------------------7
-89:----------------------------------------------------------------------------------;-------------------------------------------------------------------------------------------<=
3>>>3----------------------2----------------------------------------------------------?@-----A-------------------------------------------------------------------------------------B
99C99----------------------6DD---------------------------------------------------EFDDDDDD----6----------------------------------------GDDDD------------------------------HH--------B
99I99--------------------------------------------------------------------------JK-----------------------------------------------------L------------------DD-------------HHH--------B
>>>>>33---------------------------------------------------------MN--------------O--PQ-------------------------------------------------RS----------------------H--------THHH--------B
9C9C999---------------------------------------------------------UV----------WX-----YZ--------WX--------------WX-----------------------[\-------------DD------HH-------HHHHH--------B
9I9I999----------------]^--------------____-------------------DDH6D---------`a----DDDDDDD----`a--------------`a----WX-----------WX----DDDDD-----------------HHH------HHHHHH--------B
9999999----------------bc---M---------d-------M----ef---M-------------------gh---------------gh--------------gh----`a-----------`a-----------H----M--------HHHH-----HHHHHHH--------B
C9C9C99------------M--------U-------M-ij------U----kl---U-----------M-------mn---------------mn---------M----mno---gh-----M-----gh------p----H----U----q--HHHHH----HHHHHHHH--------B
I9I9I99------------U--------M-------U-rs------t---------u-----------U-------mn---------------mn---------U----mnv---mn-----U-----mn------wx---H----u----y-HHHHHH---HHHHHHHHH--------z
{{{{{{{{{{{{{{{{{{{{{{{{{{{{{{{{{{{{{{{{{{{{{{{{{{{{{{{{{{{{{{{{{{{{{{{{{--{{{{{{{{{{{{{{{{{{{{{{{{{{{{{{{{{{{{{|{{{{{{{{{{{{{{{{{{{{{{{{{{{{{{{{{{{{{{{-{{{{{{{{{{{{{{{{{{{{{{{{{{{
