000000000000000000000000000000000000000000000000000000000000000000000000000000000000010000000000000000000000000000000000000000000000000000000000000000020000000000000000000000000000000000000000
03330000000000000000000000045600000000000000045600000000000000000000000000045600000007800000045600000000000000000000000000045600000000000000045600000009000000000000000000045600000:000000000456
0;<=00000000000000456000000>?@455600000000000>?@455600000000000000456000000>?@45560000A000000>?@455600000000000000456000000>?@455600000000000>?@455600000000000000456000000>?@4556BC000000000>?@
3DDD30000000000000>?@000000200>??@00000000000000>??@00000000000000>?@000000000>??@0000EF00000G00>??@00000000000000>?@000000000>??@00000000000000>??@00000000000000>?@000000000>??@0H000000000000
<<I<<00000000000000000000009JJ000000000000000000000000000000000000000000000000000KLJJJJJJ00009000000000000000000000000000000000000000MNJJJJ000000000000000000000000000000OO00000000H000000000000
<<P<<00000000000000000000000000000000000000000000000000000000000000000000000000QR0000000000000000000000000000000000000000000000000000ST000000000000000000JJ00000000000UVOOO00000000H000000000000
DDDDD330000000000000000000000000000000000000000000000000000000WXYZ00000000000000[00\]0000000000000000000000000000000000000000000000000^_0000000000000000000000O00000000`OOO00000000H000000000000
<I<I<<<000000000000000000000000000000000000000000000000000000000ab0000000000cd00000ef00000000cd00000000000000cd00000000000000000000000gh0000000000000JJ000000OO0000000OOOOO00000000H000033300000
<P<P<<<0000000000000000ij00000000000000kkkk0000000000000000000JJO9J000000000lm0000JJJJJJJ0000lm00000000000000lm0000cd00000000000cd0000JJJJJ00000000000000000OOO000000OOOOOO00000000H0000;<=00000
<<<<<<<000000n0000000n0op0WXY000000000q0000nWXY0000rs0WXY0000n0000000n000000tu0000000000000n0tu00000000000000tu0000lmn0000000000lm000000v00n0O00WXY00000000OOOO00000OOOOOOO00000000H0003DDD30000
I<I<I<<0000w0x000WXY0x0ww000a00000WXY0yzw00x00a0000{|000a00w0x0000WXYx0ww000}~0000000000w00x0€0000000WXY00w0}~000tux0w‚XY00000tu000000ƒ00x0O0000a0000„00OOOOO0000OOOOOOOO00000000H000<<I<<0000
P<…†P<<0000‡0‡ˆˆˆˆ0a0‡0‡‡0WXY0000000a0‰Š‡ˆ0‡00‹0000000WXY00‡0‡ˆˆˆˆ00a‡0‡‡000}~00000000ˆˆ‡ˆ0‡0Œ000000000a00‡0}~Žˆ0‘‡0‡‡0a00000}~0000ˆˆ’“0‡0O00WXY0000”0OOOOOOˆˆˆOOOOOOOOO00000000O00ˆ<<P<<0000
••–—•••••••••••••••••••••••••••••••••••••••••••••••••••••••••••••••••••••00•••••••••••••••••••••••••••••••••••••˜••••••••••••••••••••••••˜••••••••••••••0•••••••••••••••••••••••••••••••••••••••
