00000000000000000000000000000000000000000000000000000000000000000000000000000000000000000000000000000000000000000000000000000000000000000000000000000000000000000000000000000000000000000000000000000000000000000000000000000000000000000000000000000000000000000000000000000000000000000000000000000000000000000000000000000000000000000000000000000000000000000000000000000000000000000000000000000
01110000000000000000000000023400000000000000023400000000000000000000000000023400000000000000023400000000000000000000000000023400000000000000023400000000000000000000000000023400000000000000023400000000000000000000000000023400000000000000023400000000000000000000000000023400000000000000023400000000000000000000000000023400000000000000023400000000000000000000000000023400000000005000023400000
0678000000000000002340000009:;2334000000000009:;2334000000000000002340000009:;2334000000000009:;2334000000000000002340000009:;2334000000000009:;23340000000000<0002340000009:;2334000000000009:;2334000000000000002340000009:;2334000000000009:;2334000000000000002340000009:;2334000000000009:;2334000000000000002340000009:;2334000000000009:;2334000000000000002340000009:;233400000=>00009:;23340
1???100000000000009:;0000000009::;000000000000009::;000000000000009:;0000000009::;000000000000009::;000000000@@0009:;0000000009::;000000000000009::;0000000000A0009:;0000000009::;000000000000009::;000000000000009:;0000000009::;000000000000009::;000000000000009:;0000000009::;000000000000009::;000000000000009:;0000000009::;000000000000009::;000000000000009:;0000000009::;000000B00000009::;0
77C7700000000000000000000000000000000000000000000000000000000000000000000000000000000000000000000000000000000000000000000000000000000000000000000000000000DDDDEDDD000000000000000000000000000000000000000000000000000000000000000000000000000000000000000000000000000000000000000000000000000000000000000000000000000000000000000000000000000000000000000000000000000000000000FF00000000G000000000000
77H770000000000000000000000000000000000000000000000000000000000000000000000000000000000000000000000000000000000000000000000000000000000000000000000000000000000000000000000000000000000000000000000000000000000000000000000000000000000000000000000000IJ0000000000000000000000000000000000000000000000000000000000000000000000000000000000000000000000000000000000000000000000FF00000000G000000000000
?????110000000000000000000000000000IJ000000000000000000000000000000000000000IJ00K0000000000000IJ00000000IJ00000000000000000000000000000000000000000000000000000000000000000000000000000000L0000000000000000000000000000000000000000000000000000000IJ00MN00000000000000000000000000000000F00000000000000000000000000000000000000000000000000000000000000000000000000000000000F0FF00000000G000000000000
7C7C7770000000000000000000000000000MN000000000000000000000000000@00000000000MN00E0IJ00000@0000MN00@00000MN0000000000000000000000000000000000IJ000000000000000000000000000000000000000000DDEDDDDD0000000000000000000000000000000@@0000000000000IJ00MN00OP0000000000000000000000000000000FF00@@000000@0000@0000000000000000000@@000@@000000000000000000000IJ000000000000000000F0FF00000000G000011100000
7H7H7770000000000000000000000000000OP000000000000000000000000000000000000000OP0000MN0000000000OP00000000OP000000000IJ00000000000000000000000MN00000000000F0000E0000F000000QR000000000000000000000000000000000000000000000000000000000000000000MN00OP00ST000000000000000000000000000000FFF000000000000000000000000000000000000000000000000000000000000000MN000000000IJ00000F0F0FF00000000G000067800000
7777777000000U0000000U0000000000000ST000000U00000000000000000U0000000U000000ST0000OP0000000U00ST00000000VW000U00000MNU000000000000000000000UOP00000000000F000U0XY00F0U0000Z[000\00000000000U00000000000000000U0000000U000000000000000000000U00OP00ST00ST00000U0000000U000000000000000FFFF00U00000000000000000U0000000U000000000000000000000U000000000000OP000U00000MNU0000F0F0FF00000000G00U1???10000
C7C7C770000]0^0000000^0]]0000000000ST000]_`^00000000000000a]0^0000000^0]]000ST0000ST0000]00^00ST00000000bc0]0^00000OPde]]00f0000ghij0000]00^ST00000000000F0]0^0kl00F0^0]]00000mn00000000]00^000000000000000]0opq00F00^0]]000000000000000]00^00ST00ST00ST000]0^0000000^0]]00000000000FFFFF00^000000000000000]0^0Fre0F0^0]]000000000000000]0st000000_u0v00ST0]0^00000OP^00F0F0F0FF00000000G00^77C770000
H7wxH770000y0z{|||00}~─~000000│┌00ST0||y┐└┘00000000000000├┤0y||||00┬┴┼▀▄000ST00█▌ST00||y|0y00ST00000000ST▐░┬▒▓|||0⌠■∙√yy00≈≤000≥ ⌡°²0||y|0yST0000·÷═║÷00F0y0y||||0F0y0yy00000╒ё000000||y|0y000000000000000y0╓╔╕||F00y0yy0000000000000|╖╗╘╙╚00ST00ST00ST000╛▌y|╜╝╞╟╠0╡Ёyy000000╢00FFFFFF╣╤y000000000000000y0y|F╥╦0F0y0yy0000000000000||y|╧╨000000╩╪╫╬00ST0y0y||||0STy00F0F0F0FF000000||F|0y77H770000
©©юа©©©©©©©©©©б©©©©©цдецд©©©©©©фг©©©©©©©©©х©©©0©0©©0©©0©©0©и©©©©©©©©йклйк©©©©©©©©©©©©©©©©©©©©©©©©©©©©©©©©©©лймн©©©©©©х©©©©©©©©©©оип©и©©©©©©©©©©©©©©ярся©©©©©©©©©©©©©©©©©©0©0©©0©0©©0©©©©©©©©©©©©©©©©©0©0©0©©©©ио©©©©©©©©©©©©©000000©©©©тужту©0©©00©©00©©©©©©©©©йклв©©ьы©©©©©©©©е©©©©©©©©©©©©©©©©©©000©©000©©©©©©х©©©©©©©©©00000©0000©©©©©©©©©©©©©©©х©и©©©©©©©©©©©©©©©©©0©0©0©0©©©©©©©©©©©©©©©©©©©©©©©
