-----------------------------------------------------------------------------------------------------------------------------------------------------------------------------------------------------------------------------------------------------------------------------------------------------------------------------------------------------------------------------------------
-111------------------------------------------------------------------------------------------------------------------------------------------------------------------------------------------------------------------------------------------------------------------------------------------------------------------------------------------------------------------------------------2
-345----------------------------------------------------------------------------------------------------------------------------------------------------------6------------------------------------------------------------------------------------------------------------------------------------------------------------------------------------------------------------------------78
19991--------------------------------------------------------------------------------------------------------::-----------------------------------------------;-------------------------------------------------------------------------------------------------------------------------------------------------------------------------------------------------------------------------<
44=44----------------------------------------------------------------------------------------------------------------------------------------------------->>>>?>>>------------------------------------------------------------------------------------------------------------------------------------------------------------------------------------------------------------@@--------A
44B44-------------------------------------------------------------------------------------------------------------------------------------------------------------------------------------------------------------------------------------------------CD----------------------------------------------------------------------------------------------------------------------@@--------A
9999911----------------------------CD---------------------------------------CD--E-------------CD--------CD--------------------------------------------------------------------------------F-------------------------------------------------------CD--GH--------------------------------@-----------------------------------------------------------------------------------@-@@--------A
4=4=444----------------------------GH---------------------------:-----------GH--?-CD----------GH--:-----GH----------------------------------CD------------------------------------------>>?>>>>>-------------------------------::-------------CD--GH--IJ-------------------------------@@--::------:----:-------------------::---::---------------------CD------------------@-@@--------A
4B4B444----------------------------IJ---------------------------------------IJ----GH----------IJ--------IJ---------CD-----------------------GH-----------@----?----@------K-------------------------------------------------------------------GH--IJ--LM------------------------------@@@---------------------------------------------------------------GH---------CD-----@-@-@@--------A
4444444----------------------------LM---------------------------------------LM----IJ----------LM--------LN---------GH-----------------------IJ-----------@-----OP--@------Q----R--------------------------------------------------------------IJ--LM--LM-----------------------------@@@@---------------------------------------------------------------IJ---------GH-----@-@-@@--------A
=4=4=44----------------------------LM----ST---------------U-----------------LM----LM----------LM--------LV---------IJW-----X----YZ[\--------LM-----------@-----]^--@----------_`-----------------------------abc--@---------------------------LM--LM--LM----------------------------@@@@@----------------------@-d-@----------------------ef------Sg-d--LM---------IJ---@-@-@-@@--------A
B4B4B44-------------hijki------lm--LM----nop--------------qr--------stusv---LM----LM----------LM--------LMwusxi----Lyz-----{|---}~€-------LM----‚ƒ„…ƒ--@---------@----------†‡-----------------------------ˆ‰Š--@--------------------„‹Œ„--LM--LM--LM-------stuŽ-‘--------’“--@@@@@@----------------------@-”-@----------------------•–------n—˜”--LM---------LM---@-@-@-@@--------@
™™™™™™™™™™™™™™š™™™™™›œ›œ™™™™™™žŸ™™™™™™™™™ ™™™-™-™™-™™-™™-™¡™™™™™™™™¢£¤¢£™™™™™™™™™™™™™™™™™™™™™™™™™™™™™™™™™™¤¢¥¦™™™™™™ ™™™™™™™™™™§¡¨™¡™™™™™™™™™™™™™™©ª«©™™™™™™™™™™™™™™™™™™-™-™™-™-™™-™¬­­­­­­­®™™™™™™™-™-™-™™™™¡§™™™™™™™™™™™™™------™™™™¯°±¯°™-™™--™™--™™™™™™™™™¢£¤²™™³´™™™™™™™™™™™™™™™™™­­­­µ™™™™---™™---™™™™™™ ™™™™™™™™™-----™----™™™™™™™™™™™™™™™ ™¡™™™™™™™™™™™™™™™™™-™-™-™-™™™™™™™™™™™
