0000000000000000000000120000000000000000000000000000000000000000000000000000000000000000000000000000000000000000000000000000000000000000000000000000000000000000000000000000000000000000000000000000000000000000000000000000000000000
0000000000000000000034560007890000000000000007890000000000000000000000000007890000000000000007890000000000000000000000000007:9000000000000000789000000000000000000000000000789000000000000000789000000000000000000000000;007890000000
78890000000000000078<=00000>?@788900000000000>?@788900000000000000789000000>?@788900000000000>?@788900000000000000789000000>?@788900000000000>?@788900000000000000789000000>?@788900000000000>?@78890000000000000078900AB00>?@7889000
>??@00000000000000>?@C00000000>??@0000000000D000>??@00000000000000>?@000000000>??@00000000000000>??@00000000000000>?@000000000>??@00000000000000>??@00000000000000>?@000000000>??@00000000000000>??@00000EF0000000>?@000G00000>??@000
000000000000000000000000HH00000000000000000IJIIIIIIIIIIIIIIIIIIIIIIIIIIIIIII00000000000000000000000000000000000000000000000000000000000000000000000000000000000000000000000000000000000000000000000000000KL000HH00000000M000000000000
00000000000000000000000HHH000000000000000000000000000000000000000000000000000000000000000000000000000000000000000000000000000000000000000000000000000000000000000000000000000000000000000000000000000000000000HH00000000M000000000000
000000000000000000000NHHHH0000000000000000000000000000000000000000000000000000000000000000000000000000000000000000000000O00000000000000000000000000000000000PQ000000000000000000000000000000000000000000000000HH00000000M000000000000
0RRR00000000000000000SHHHH00000000000000000000000000000000000000000000000000000000000000000000000000T0000000000000000UVWX00000000000000000000000000000000000YZ000000000000000[\000000000]^H0000000000000000H00HH00000000M0000RRR00000
0_`a00000000000bc000H0HHHH000dddd000000000000000000000ef0000000gh00ij00000000II00000000000000000000IJ000000000II000000IHJ0000000000PQ0000kl000PQ000000000000mn00000PQ0op00000qr000000000stH0000000000000000H00HH00000000M0000_`a00000
RuuuR00000000v0wx00HH0HHHH00000000000000000v0000000000yz00000v0{|00}~v00000000000000000000ÄVWÅÇ0000000000000v0000000v00000UVW00000YZ0000ÉÑv00YZ000000000000ÖÜ00000YZv0á0àâ00000000000äãHHHv0UVW000000000H0H00HH00000v00M000RuuuR0000
``å``000000ç0é0000HHH0HHHH00000000000000ç00éè00000000000000ç0é0000000é0çç0000000000UVW00ç0êé0ëíì0000000UVW0ç0é0000000é0çç0000ë00000mn000çîïé00mn00000000000çñó00000mné0ççòô00UVW000000öõHHHé000ë00000000HH0H00HH00000é0çM000``å``0000
``úù`000000û0ûü0üHHHH0HHHH000000000000üüûü0û†00000000000000û0ûü0üü000û0ûû000000000000ëüüûü0°VW00000000000ë0û¢£üüü§VW0•¶ûß®000©00000™´0üüûü0û00™´00000000000û™´üüüü0¨≠û0ûû000000ë000000HHHHHÆØUVW0000000HHH0H00HHüü000û0ûH000``∞``0000
±±≤≥±±±±±±±±±±±0±±±±±0±±±±±±±±±±±±±±0±±±±±±±±0±±±±0±0±±±0±±±±±±0±±±±±±±±±±±±±±00±±±±0±±±±±±±±±±±±±±±±±±±±±±±¥±±±±±±±±±µ±¥±±±±±±±±±±±±±±±±±0±±±±±0±0±000000±±±±±±±±±±±±±±±±±±±±0±000±±±±±±±±±∂±±±±±±±±±±±±±0±00±±±±±±±±±±±±±±±±±±±±±±±
