!!!!!!!!!!!!!!!!!!!!!!"#!!!!!!!!!!!!!!!!!!!!!!!!!!!!!!!!!!!!!!!!!!!!!!!!!!!!!!!!!!!!!!!!!!!!!!!!!!!!!!!!!!!!!!!!!!!!!!!!!!!!!!!!!!!!!!!!!!!!!!!!!!!!!!!!!!!!!!!!!!!!!!!!!!!!!!!!!!!!!!!!!!!!!!!!!!!!!!!!!!!!!!!!!!!!!!!!!!!!!!!!!!!!!
!!!!!!!!!!!!!!!!!!!!$%&'!!!()*!!!!!!!!!!!!!!!()*!!!!!!!!!!!!!!!!!!!!!!!!!!!()*!!!!!!!!!!!!!!!()*!!!!!!!!!!!!!!!!!!!!!!!!!!!(+*!!!!!!!!!!!!!!!()*!!!!!!!!!!!!!!!!!!!!!!!!!!!()*!!!!!!!!!!!!!!!()*!!!!!!!!!!!!!!!!!!!!!!!!,!!()*!!!!!!!
())*!!!!!!!!!!!!!!()-.!!!!!/01())*!!!!!!!!!!!/01())*!!!!!!!!!!!!!!()*!!!!!!/01())*!!!!!!!!!!!/01())*!!!!!!!!!!!!!!()*!!!!!!/01())*!!!!!!!!!!!/01())*!!!!!!!!!!!!!!()*!!!!!!/01())*!!!!!!!!!!!/01())*!!!!!!!!!!!!!!()*!!23!!/01())*!!!
/001!!!!!!!!!!!!!!/014!!!!!!!!/001!!!!!!!!!!5!!!/001!!!!!!!!!!!!!!/01!!!!!!!!!/001!!!!!!!!!!!!!!/001!!!!!!!!!!!!!!/01!!!!!!!!!/001!!!!!!!!!!!!!!/001!!!!!!!!!!!!!!/01!!!!!!!!!/001!!!!!!!!!!!!!!/001!!!!!67!!!!!!!/01!!!8!!!!!/001!!!
!!!!!!!!!!!!!!!!!!!!!!!!99!!!!!!!!!!!!!!!!!:;:::::::::::::::::::::::::::::::!!!!!!!!!!!!!!!!!!!!!!!!!!!!!!!!!!!!!!!!!!!!!!!!!!!!!!!!!!!!!!!!!!!!!!!!!!!!!!!!!!!!!!!!!!!!!!!!!!!!!!!!!!!!!!!!!!!!!!!!!!!!!<=!!!99!!!!!!!!>!!!!!!!!!!!!
!!!!!!!!!!!!!!!!!!!!!!!999!!!!!!!!!!!!!!!!!!!!!!!!!!!!!!!!!!!!!!!!!!!!!!!!!!!!!!!!!!!!!!!!!!!!!!!!!!!!!!!!!!!!!!!!!!!!!!!!!!!!!!!!!!!!!!!!!!!!!!!!!!!!!!!!!!!!!!!!!!!!!!!!!!!!!!!!!!!!!!!!!!!!!!!!!!!!!!!!!!!!99!!!!!!!!>!!!!!!!!!!!!
!!!!!!!!!!!!!!!!!!!!!?9999!!!!!!!!!!!!!!!!!!!!!!!!!!!!!!!!!!!!!!!!!!!!!!!!!!!!!!!!!!!!!!!!!!!!!!!!!!!!!!!!!!!!!!!!!!!!!!@!!!!!!!!!!!!!!!!!!!!!!!!!!!!!!!!!!!AB!!!!!!!!!!!!!!!!!!!!!!!!!!!!!!!!!!!!!!!!!!!!!!!!99!!!!!!!!>!!!!!!!!!!!!
!CCC!!!!!!!!!!!!!!!!!D9999!!!!!!!!!!!!!!!!!!!!!!!!!!!!!!!!!!!!!!!!!!!!!!!!!!!!!!!!!!!!!!!!!!!!!!!!!!E!!!!!!!!!!!!!!!!FGHI!!!!!!!!!!!!!!!!!!!!!!!!!!!!!!!!!!!JK!!!!!!!!!!!!!!!LM!!!!!!!!!NO9!!!!!!!!!!!!!!!!9!!99!!!!!!!!>!!!!CCC!!!!!
!PQR!!!!!!!!!!!ST!!!9!9999!!!UUUU!!!!!!!!!!!!!!!!!!!!!VW!!!!!!!XY!!Z[!!!!!!!!::!!!!!!!!!!!!!!!!!!!!:;!!!!!!!!!::!!!!!!:9;!!!!!!!!!!AB!!!!\]!!!AB!!!!!!!!!!!!^_!!!!!AB!`a!!!!!bc!!!!!!!!!de9!!!!!!!!!!!!!!!!9!!99!!!!!!!!>!!!!PQR!!!!!
CfffC!!!!!!!!g!hi!!99!9999!!!!!!!!!!!!!!!!!g!!!!!!!!!!jk!!!!!g!lm!!nog!!!!!!!!!!!!!!!!!!!!pqGHrs!!!!!!!!!!!!!g!!!!!!!g!!!!!FGH!!!!!JK!!!!tug!!JK!!!!!!!!!!!!vw!!!!!JKg!x!yz!!!!!!!!!!!{|999g!FGH!!!!!!!!!9!9!!99!!!!!g!!>!!!CfffC!!!!
QQ}QQ!!!!!!~!!!!!999!9999!!!!!!!!!!!!!!~!!Ä!!!!!!!!!!!!!!~!!!!!!!!!~~!!!!!!!!!!FGH!!~!Å!ÇÉÑ!!!!!!!FGH!~!!!!!!!!!~~!!!!Ç!!!!!^_!!!~ÖÜ!!^_!!!!!!!!!!!~áà!!!!!^_!~~âä!!FGH!!!!!!ãå999!!!Ç!!!!!!!!99!9!!99!!!!!!~>!!!QQ}QQ!!!!
QQçéQ!!!!!!è!èê!ê9999!9999!!!!!!!!!!!!êêèê!èë!!!!!!!!!!!!!!è!èê!êê!!!è!èè!!!!!!!!!!!!Çêêèê!íGH!!!!!!!!!!!Ç!èìîêêêïGH!ñóèòô!!!ö!!!!!õú!êêèê!è!!õú!!!!!!!!!!!èõúêêêê!ùûè!èè!!!!!!Ç!!!!!!99999ü†FGH!!!!!!!999!9!!99êê!!!è!è9!!!QQ°QQ!!!!
¢¢£§¢¢¢¢¢¢¢¢¢¢¢!¢¢¢¢¢!¢¢¢¢¢¢¢¢¢¢¢¢¢¢!¢¢¢¢¢¢¢¢!¢¢¢¢!¢!¢¢¢!¢¢¢¢¢¢!¢¢¢¢¢¢¢¢¢¢¢¢¢¢!!¢¢¢¢!¢¢¢¢¢¢¢¢¢¢¢¢¢¢¢¢¢¢¢¢¢¢¢•¢¢¢¢¢¢¢¢¢¶¢•¢¢¢¢¢¢¢¢¢¢¢¢¢¢¢¢¢!¢¢¢¢¢!¢!¢!!!!!!¢¢¢¢¢¢¢¢¢¢¢¢¢¢¢¢¢¢¢¢!¢!!!¢¢¢¢¢¢¢¢¢ß¢¢¢¢¢¢¢¢¢¢¢¢¢!¢!!¢¢¢¢¢¢¢¢¢¢¢¢¢¢¢¢¢¢¢¢¢¢¢
