0000000000000000000000000000000000000000000000000000000000000000000000000000000000000000000000000000000000000000000000000000000000000000000000000000000000000000000000000000000000000000000000000000000000000000000000000000000000000
0000000000000000000000000001230000000000000001230000000000000000000000000001230000000000000001230000000000000000000000000001230000000000000001230000000000000000000000000001230000000000000001230000000000000000000000400001230555000
1223000000000000001230000006781223000000000006781223000000000000001230000006781223000000000006781223000000000000001230000006781223000000000006781223000000000000001230000006781223000000000006781223000000000000001239:00006780;<=000
677800000000000000678000000000677800000000000000677800000000000000>7800000000067780000000000000067780000000000000067?0000000006778000000000000006778000000000000006780000000006778000000000000006778000000000000006780@00000005AAA500
000000000000000000000000000000000000000000000000000000000000BBBBBBCB00000000000000000000000000000000000000000000000BCBBBBBB000000000000000000000000000000000000000000000000000000000000000000000000000000000DD00000000E0000000<<F<<00
00000000000000000000000000000000000000000000000000000000000000000000000000000000000000000000000000000000000000000000000G0000000000000000000000000000000000000000000000000000000000000000000000000000000000000000000000E0000000<<H<<00
00000000000000000000000055555555000005555555555555500IJ00000000KL000000000000005555550005555550005555555555000000000000MN00000IJ00005555555555555555555555555555555555000000555555555555555555O50000000000D00000000000E0000055AAAAA55
055500000000000000000000<<<<<<<<00000<<<<<<<<<<<<<<00PQ00000000RS00000000000000<<<<<<000<<<<<<000<<<<<<<<<<000000000000RT00000PQ0000<<<<<<<<<<<<U<<<<<<<<<<<<<<<<<<<<<00IJ00<<<<<<<<<<<<<<<<<<V<0000000000000000000000E00000<<<F<F<<<
0;<=00000000000000000000<<<<<<<<00000<<<<<<<<<<<<<<00WX00000BBBBBBBB000D0000000<<<<<<000<<<<<<000<<<<<<<<<<00DD0000BBBBBBBB000WX0000<<<<<<<<<<<<Y<<<<<<<<<<<<<<<<<<<<<00PQ00<<<<<<<<<<<<<<<<<<C<00000000D0000000000000E00000<<<H<H<<<
5AAA500000000Z0000000Z00<<<[\<<<]^_00<<<<<<<<<<<<<<00`a000000Z000000000DD000000<<<<<<000<<bc<<0D0<<<<<<<<<<00DD000000Z00000000`a0000<<<<<<<<<<<<<d<<<<<<<<<<<<<ef<<<<<00WX00<<<<<<<<<<<<<<<<<<<<000000000000000000000ZE00000<<<<<<<<<
<<F<<000000g0h00]^_00h0g<<<ij<<<00k00<<<<<<<<<<<<<<00`a0000g0h000lm0000DDD00000<<<<<n^_0<<op<<0D0<<<<<<<<<<g0DD000000hqgg00000`a0000<<<<r<<<<<<<<s<<<<<<<<<<<<<tu<<<<<0g`a00<<<<vw<<<<<<<xy<<<<<000D00D00000000000000hEgg000<<F<F<F<<
<<z{<000000|0|}}}}k00|0|<<<~<<<00€00<<<<<<<<<<<<<<00`a0000|0|}}}‚0000DDDD0000<<<<<<0k}<<<<<<0D0<<<<<<<<<<|0DD}}}000|ƒ||00000`a0000<<<<„…<<<<<<<†‡<<<<<<<<<<<<<<<<<<<0|`a00<<<<ˆ‰<<<<<<<Š‹<<<<<000D000000000000}}000|D||000<<H<H<H<<
ŒŒŽŒŒŒŒŒŒŒŒŒŒŒŒŒŒŒŒŒŒŒŒŒŒŒŒŒŒŒŒŒŒŒŒŒŒŒŒŒŒŒŒŒŒŒŒŒŒŒŒŒŒŒŒŒŒŒŒŒŒŒŒŒŒŒŒŒ00ŒŒŒŒ00ŒŒŒŒŒŒŒŒŒŒŒŒŒŒŒŒŒŒŒŒŒŒŒŒŒŒŒŒŒŒŒŒŒŒŒŒŒŒŒŒŒŒŒŒŒŒ00ŒŒ00ŒŒŒŒŒŒ‘ŒŒŒŒŒŒŒŒ‘ŒŒŒŒŒŒŒŒŒŒŒŒŒŒŒŒŒŒŒŒŒŒŒŒŒŒŒŒŒŒŒŒŒŒŒŒŒŒ‘ŒŒŒŒŒŒŒŒŒŒ00000000000ŒŒŒŒŒŒŒŒŒŒŒŒŒŒŒŒŒŒŒŒŒ
