\\\\\\\\\\\\\\\\\\\\\\\\\\\\\\\\\\\\\\\\\\\\\\\\\\\\\\\\\\\\\\\\\\\\\\\\\\\\\\\\\\\\\\\\\\\\\\\\\\\\\\\\\\\\\\\\\\\\\\\\\\\\\\\\\\\\\\\\\\\\\\\\\\\\\\\\\\\\\\\\\\\\\\\\\\\\\\\\\\\\\\\\\\\\\\\\\\\\\\\\\\\\\\\\\\\\\\\
\\\\\\\\\\\\\\\\\\\\\\\\\\\\\\\\\\\\\\\\\\\\\\\\\\\\\\\\\\\\\\\\\\\\\\\\\\\\\\\\\\\\\\\\\\\\\\\\\\\\\\\\\\\\\\\\\\\\\\\\\\\\\\\\\\\\\\\\\\\\\\\\\\\\\\\\\\\\\\\\\\\\\\\\\\\\\\\\\\\\\\\\\\\\\\\\\\\\\\\\\\\\\\\\\\\\\\]
\\\\\\\\\\\\\\\\\\\\\\\\\\\\\\\\\\\\\\\\\\\\\\\\\\\\\\\\\\\\\\\\\\\\\\\\\\\\\\\\\\\\\\\\\\\\\\\\\\\\\\\\\\\\\\\\\\\\\\\\\\\\\\\\\\\\\\\\\\\\\\\\\\\\\\\\\\\\\\\\\\\\\\\\\\\\\\\\\\\\\\\\\\\\\\\\\\\\\\\\\\\\\\\\\\\\\^_
\\\\\\\\\\\\\\\\\\\\\\\\\\\\\\\\\\\\\\\\\\\\\\\\\\\\\\\\\\\\\\\\\\`\\\\\\\\\\\\\\\\\\\\\\\\\\\\\\\\\\\\\\\\\\\\\\\\\a\\\\\\\\\\\\\\\\\\\\\\\\\\\\\\\\\\\\\\\\\\\\\\\\\\\\\\\\\\\\\\\\\\\\\\\\\\\\\\\\\\\\\\\\\\\\\\\\\b
\\\\\\\\\\\\\\\\\\\\\\\\\\\\\\\\\\\\\\\\\\\\\\\\\\\\\\\\\\\\ccccccdc\\\\\\\\\\\\\\\\\\\\\\\\\\\\\\\\\\\\\\\\\\\\\\\cdcccccc\\\\\\\\\\\\\\\\\\\\\\\\\\\\\\\\\\\\\\\\\\\\\\\\\\\\\\\\\\\\\\\\\\\\\\\\\\\\\\\\\ee\\\\\\\\f
\\\\\\\\\\\\\\\\\\\\\\\\\\\\\\\\\\\\\\\\\\\\\\\\\\\\\\\\\\\\\\\\\\\\\\\\\\\\\\\\\\\\\\\\\\\\\\\\\\\\\\\\\\\\\\\\\\\\\\\\\\\\\\\\\\\\\\\\\\\\\\\\\\\\\\\\\\\\\\\\\\\\\\\\\\\\\\\\\\\\\\\\\\\\\\\\\\\\\\\\\\\\\\\\\\\\\\f
\\\\\\\\\\\\\\\\\\\\\\\\\\\\\\\\\\\\\\\\\\\\\\\\\\\\\gh\\\\\\\\ij\\\\\\\\\\\\\\\\\\\\\\\\\\\\\\\\\\\\\\\\\\\\\\\\\\\\\\kl\\\\\gh\\\\\\\\\\\\\\\\\\\\\\\\\\\\\\\\\\\\\\\\\\\\\\\\\\\\\\\\\\\\\\m\\\\\\\\\\\e\\\\\\\\\\\f
\nnn\\\\\\\\\\\\\\\\\\\\\\\\\\\\\\\\\\\\\\\\\\\\\\\\\op\\\\\\\\qr\\\\\\\\\\\\\\\\\\\\\\\\\\\\\\\\\\\\\\\\\\\\\\\\\\\\\\qs\\\\\op\\\\\\\\\\\\\\\\\\\\\\\\\\\\\\\\\\\\\\\\gh\\\\\\\\\\\\\\\\\\\\t\\\\\\\\\\\\\\\\\\\\\\\f
\uvw\\\\\\\\\\\\\\\\\\\\\\\\\\\\\\\\\\\\\\\\\\\\\\\\\xy\\\\\cccccccc\\\e\\\\\\\\\\\\\\\\\\\\\\\\\\\\\\\\\\\\\ee\\\\cccccccc\\\xy\\\\\\\\\\\\\\\\\\\\\\\\\\\\\\\\\\\\\\\\op\\\\\\\\\\\\\\\\\\\\z\\\\\\\\\e\\\\\\\\\\\\\f
n{{{n\\\\\\\\\\\\\\\\\\\\\\|}\\\\\~\\\\\\\\\\\\\\\\\\Ä\\\\\\\\\\\\\\\\ee\\\\\\\\\\\\\\\\\ÅÇ\\\e\\\\\\\\\\\\\ee\\\\\\\\\\\\\\\Ä\\\\\\\\\\\\\\\\\\\\\\\\\\\\\\\\É\\\\\\\xy\\\\\\\\\\\\\\\\\\\\\\\\\\\\\\\\\\\\\\\\\\\Ñf
vvÖvv\\\\\\\\\\\\\~\\\\\\\\Üá\\\\\à\\\\\\\\\\\\\\\\\\Ä\\\\\\\\\\âä\\\\eee\\\\\\\\\\\\ã\\\åç\\\e\\\\\\\\\\\\\ee\\\\\\\é\\\\\\\Ä\\\\\\\\è\\\\\\\\ê\\\\\\\\\\\\\\ë\\\\\\\Ä\\\\\\\í\\\\\\\ìî\\\\\\\\e\\e\\\\\\\\\\\\\\ïf
vvñvv\\\\\\\\\\\\\à\\\\\\\\óò\\\\\ô\\\\\\\\\\\\\\\\\\Ä\\\\\\\\\\öõ\\\\eeee\\\\\\\\\\\ú\\\\\\\\e\\\\\\\\\\\\\ee\\\\\\\ù\\\\\\\Ä\\\\\\\\ûü\\\\\\\†°\\\\\\\\\\\\\\\\\\\\\Ä\\\\\\\¢\\\\\\\£§\\\\\\\\e\\\\\\\\\\\\\\\\\•e
¶¶¶¶¶¶¶¶¶¶¶¶¶¶¶¶¶¶¶¶¶¶¶¶¶¶¶¶¶¶¶¶¶¶¶¶¶¶¶¶¶¶¶¶¶¶¶¶¶¶¶¶¶¶¶¶¶¶¶¶¶¶¶¶¶¶¶¶¶\\¶¶¶¶\\¶¶¶¶¶¶¶¶¶¶¶¶¶¶¶¶¶¶¶¶¶¶¶¶¶¶¶¶¶¶¶¶¶¶¶¶¶¶¶¶¶ß¶¶¶¶¶\\¶¶\\¶¶¶¶¶¶®©¶¶¶¶¶¶¶¶©¶¶¶¶¶¶¶¶¶¶¶¶¶¶¶¶¶¶¶¶¶¶¶¶¶¶¶¶¶¶ß¶¶¶¶¶¶¶¶©¶¶¶¶¶¶¶¶¶¶\\\\\\\\\\\¶¶¶¶¶¶¶
